Rk,Season,Tm,TMSeason,G,W,L,W/L%,MP,FG,FGA,2P,2PA,3P,3PA,FT,FTA,ORB,DRB,TRB,AST,STL,BLK,TOV,PF,PTS
39,1979-80,ATL,1979-80ATL`,82,50,32,0.61,19780,3261,7027,3248,6952,13,75,2038,2645,1369,2406,3775,1913,782,539,1495,2293,8573
38,1980-81,ATL,1980-81ATL,82,31,51,0.402,19930,3291,6866,3281,6784,10,82,2012,2590,1201,2224,3425,1846,749,469,1605,2276,8604
37,1981-82,ATL,1981-82ATL,82,42,40,0.52,19880,3210,6776,3182,6648,28,128,1833,2387,1135,2368,3503,1815,608,485,1343,2268,8281
36,1982-83,ATL,1982-83ATL,82,43,39,0.537,19780,3352,7146,3307,6958,45,188,1586,2111,1139,2433,3572,1945,573,665,1424,2022,8335
35,1983-84,ATL,1983-84ATL,82,40,42,0.5,19855,3230,6809,3207,6703,23,106,1838,2414,1112,2232,3344,1827,626,558,1329,2091,8321
34,1984-85,ATL,1984-85ATL,82,34,48,0.439,19855,3444,7119,3371,6884,73,235,1782,2371,1161,2345,3506,2009,665,541,1475,2047,8743
33,1985-86,ATL,1985-86ATL,82,50,32,0.61,19805,3447,7029,3414,6863,33,166,1979,2704,1249,2405,3654,2025,736,434,1483,2170,8906
32,1986-87,ATL,1986-87ATL,82,57,25,0.695,19730,3435,7141,3300,6716,135,425,2019,2661,1350,2478,3828,2077,700,511,1279,2152,9024
31,1987-88,ATL,1987-88ATL,82,50,32,0.61,19780,3443,7102,3358,6820,85,282,1873,2441,1228,2379,3607,2062,635,537,1225,2050,8844
30,1988-89,ATL,1988-89ATL,82,52,30,0.646,19805,3412,7230,3302,6833,110,397,2168,2709,1372,2316,3688,1990,817,474,1310,1880,9102
29,1989-90,ATL,1989-90ATL,82,41,41,0.512,19730,3417,7019,3293,6608,124,411,1943,2544,1273,2187,3460,1820,717,353,1270,1871,8901
28,1990-91,ATL,1990-91ATL,82,43,39,0.537,19755,3349,7223,3078,6387,271,836,2034,2544,1235,2420,3655,1864,729,374,1231,1768,9003
27,1991-92,ATL,1991-92ATL,82,38,44,0.488,19905,3492,7476,3282,6805,210,671,1517,2074,1288,2498,3786,2123,793,320,1255,1771,8711
26,1992-93,ATL,1992-93ATL,82,43,39,0.537,19830,3392,7272,3010,6196,382,1076,1648,2221,1290,2344,3634,2084,806,278,1339,1807,8814
25,1993-94,ATL,1993-94ATL,82,57,25,0.695,19755,3247,7039,2979,6209,268,830,1556,2070,1250,2423,3673,2056,915,449,1252,1625,8318
24,1994-95,ATL,1994-95ATL,82,42,40,0.537,19855,2986,6680,2447,5100,539,1580,1410,1948,1104,2272,3376,1757,738,412,1221,1804,7921
23,1995-96,ATL,1995-96ATL,82,46,36,0.573,19730,2985,6665,2419,5070,566,1595,1523,2012,1182,2148,3330,1609,771,319,1228,1714,8059
22,1996-97,ATL,1996-97ATL,82,56,26,0.695,19805,2812,6307,2153,4473,659,1834,1491,1955,1021,2350,3371,1557,701,427,1228,1591,7774
21,1997-98,ATL,1997-98ATL,82,50,32,0.62,19880,2887,6352,2550,5336,337,1016,1749,2314,1106,2417,3523,1569,653,491,1214,1671,7860
20,1998-99,ATL,1998-99ATL,50,31,19,0.402,12075,1539,3760,1342,3116,197,644,1040,1422,676,1499,2175,782,346,260,745,987,4315
19,1999-00,ATL,1999-00ATL,82,28,54,0.366,19830,3000,6807,2742,5993,258,814,1477,1987,1146,2570,3716,1548,500,461,1266,1718,7735
18,2000-01,ATL,2000-01ATL,82,25,57,0.329,19730,2876,6668,2543,5735,333,933,1374,1811,1028,2490,3518,1559,634,387,1368,1863,7459
17,2001-02,ATL,2001-02ATL,82,33,49,0.427,19780,2901,6610,2478,5416,423,1194,1486,1942,955,2445,3400,1656,667,350,1275,1702,7711
16,2002-03,ATL,2002-03ATL,82,35,47,0.451,19905,2859,6434,2457,5293,402,1141,1594,2011,937,2558,3495,1679,611,473,1367,1783,7714
15,2003-04,ATL,2003-04ATL,82,28,54,0.366,19905,2829,6529,2410,5280,419,1249,1534,1976,996,2507,3503,1648,627,408,1350,1826,7611
14,2004-05,ATL,2004-05ATL,82,13,69,0.207,19855,2942,6672,2638,5699,304,973,1417,1994,1100,2335,3435,1614,629,344,1319,2009,7605
13,2005-06,ATL,2005-06ATL,82,26,56,0.341,19880,2946,6496,2522,5342,424,1154,1656,2207,1069,2232,3301,1625,587,394,1284,2054,7972
12,2006-07,ATL,2006-07ATL,82,30,52,0.39,19880,2831,6372,2490,5334,341,1038,1677,2203,976,2312,3288,1573,609,446,1306,1970,7680
11,2007-08,ATL,2007-08ATL,82,37,45,0.476,19855,2975,6552,2591,5474,384,1078,1720,2227,1008,2454,3462,1804,600,448,1223,1673,8054
10,2008-09,ATL,2008-09ATL,82,47,35,0.598,19705,2956,6451,2359,4818,597,1633,1537,2085,870,2412,3282,1657,603,376,1048,1610,8046
9,2009-10,ATL,2009-10ATL,82,53,29,0.659,19855,3181,6801,2657,5346,524,1455,1452,1914,969,2451,3420,1789,592,413,980,1632,8338
8,2010-11,ATL,2010-11ATL,82,44,38,0.549,19730,2971,6429,2469,5002,502,1427,1346,1728,762,2460,3222,1802,497,341,1118,1554,7790
7,2011-12,ATL,2011-12ATL,66,40,26,0.5,16165,2429,5348,1937,4018,492,1330,1025,1385,652,2066,2718,1481,536,303,921,1178,6375
6,2012-13,ATL,2012-13ATL,82,44,38,0.549,19855,3084,6644,2378,4743,706,1901,1158,1619,758,2593,3351,2007,664,369,1219,1473,8032
5,2013-14,ATL,2013-14ATL,82,38,44,0.488,19830,3061,6688,2293,4572,768,2116,1392,1782,713,2565,3278,2041,680,326,1251,1577,8282
4,2014-15,ATL,2014-15ATL,82,60,22,0.744,19730,3121,6699,2303,4547,818,2152,1349,1735,715,2611,3326,2111,744,380,1167,1457,8409
3,2015-16,ATL,2015-16ATL,82,48,34,0.61,19830,3168,6923,2353,4597,815,2326,1282,1638,679,2772,3451,2100,747,486,1226,1570,8433
2,2016-17,ATL,2016-17ATL,82,43,39,0.545,19880,3123,6918,2394,4781,729,2137,1484,2039,842,2793,3635,1938,672,397,1294,1491,8459
1,2017-18,ATL,2017-18ATL,7,1,6,0.125,1680,257,606,189,424,68,182,115,134,63,228,291,146,63,24,101,154,697
39,1979-80,BOS,1979-80BOS,82,61,21,0.744,19880,3617,7387,3455,6965,162,422,1907,2449,1227,2457,3684,2198,809,308,1539,1974,9
38,1980-81,BOS,1980-81BOS,82,62,20,0.756,19780,3581,7099,3516,6858,65,241,1781,2369,1155,2424,3579,2202,683,594,1577,1990,9008
37,1981-82,BOS,1981-82BOS,82,63,19,0.768,19780,3657,7334,3608,7150,49,184,1817,2457,1253,2489,3742,2126,652,568,1452,2014,9180
36,1982-83,BOS,1982-83BOS,82,56,26,0.683,19830,3711,7547,3672,7361,39,186,1730,2348,1273,2532,3805,2216,789,521,1541,2062,9191
35,1983-84,BOS,1983-84BOS,82,62,20,0.756,19955,3616,7235,3561,7006,55,229,1907,2407,1159,2538,3697,2122,673,430,1420,1949,9194
34,1984-85,BOS,1984-85BOS,82,63,19,0.768,19705,3721,7325,3611,7016,110,309,1860,2307,1116,2630,3746,2287,645,414,1332,1781,9412
33,1985-86,BOS,1985-86BOS,82,67,15,0.817,19855,3718,7312,3580,6919,138,393,1785,2248,1054,2753,3807,2387,641,511,1360,1756,9359
32,1986-87,BOS,1986-87BOS,82,59,23,0.72,19805,3645,7051,3438,6486,207,565,1740,2153,933,2585,3518,2421,561,526,1300,1710,9237
31,1987-88,BOS,1987-88BOS,82,57,25,0.695,19780,3599,6905,3328,6200,271,705,1846,2300,930,2440,3370,2448,620,415,1304,1804,9315
30,1988-89,BOS,1988-89BOS,82,42,40,0.524,19780,3520,7143,3442,6834,78,309,1840,2349,1179,2442,3621,2189,639,418,1336,1876,8958
29,1989-90,BOS,1989-90BOS,82,52,30,0.646,19705,3563,7148,3457,6744,106,404,1791,2153,1066,2707,3773,2423,539,455,1256,1717,9023
28,1990-91,BOS,1990-91BOS,82,56,26,0.683,19805,3695,7214,3586,6868,109,346,1646,1997,1088,2697,3785,2160,672,565,1320,1695,9145
27,1991-92,BOS,1991-92BOS,82,51,31,0.634,19780,3543,7196,3433,6837,110,359,1549,1917,1095,2583,3678,2072,636,484,1165,1686,8745
26,1992-93,BOS,1992-93BOS,82,48,34,0.598,19780,3453,7093,3343,6710,110,383,1486,1912,1076,2436,3512,1999,647,458,1174,1862,8502
25,1993-94,BOS,1993-94BOS,82,32,50,0.415,19905,3333,7057,3195,6580,138,477,1463,2003,1037,2380,3417,1928,674,440,1242,1849,8267
24,1994-95,BOS,1994-95BOS,82,35,47,0.451,19805,3179,6847,2817,5863,362,984,1708,2268,1156,2320,3476,1783,612,361,1305,1975,8428
23,1995-96,BOS,1995-96BOS,82,33,49,0.427,19905,3163,6942,2624,5489,539,1453,1630,2284,1050,2427,3477,1792,653,406,1302,2041,8495
22,1996-97,BOS,1996-97BOS,82,15,67,0.232,19905,3066,6967,2599,5636,467,1331,1649,2199,1095,2188,3283,1792,810,315,1342,1915,8248
21,1997-98,BOS,1997-98BOS,82,36,46,0.463,19730,3012,6934,2597,5685,415,1249,1425,1964,1196,2044,3240,1816,987,366,1330,2203,7864
20,1998-99,BOS,1998-99BOS,50,19,31,0.256,12150,1816,4164,1543,3406,273,758,745,1077,680,1458,2138,1073,453,255,807,1193,4650
19,1999-00,BOS,1999-00BOS,82,35,47,0.451,19730,3054,6880,2637,5620,417,1260,1621,2175,1108,2420,3528,1741,795,286,1259,2223,8146
18,2000-01,BOS,2000-01BOS,82,36,46,0.463,19830,2773,6485,2181,4852,592,1633,1621,2190,897,2367,3264,1708,769,336,1285,1952,7759
17,2001-02,BOS,2001-02BOS,82,49,33,0.61,19830,2852,6731,2153,4785,699,1946,1498,1960,891,2570,3461,1722,793,292,1114,1776,7901
16,2002-03,BOS,2002-03BOS,82,44,38,0.561,19830,2700,6509,1981,4354,719,2155,1480,1994,849,2471,3320,1575,720,303,1147,1758,7599
15,2003-04,BOS,2003-04BOS,82,36,46,0.463,19705,2843,6415,2290,4816,553,1599,1572,2095,851,2440,3291,1683,770,331,1332,1837,7811
14,2004-05,BOS,2004-05BOS,82,45,37,0.561,19880,3046,6511,2609,5259,437,1252,1775,2323,909,2438,3347,1810,667,423,1297,2000,8304
13,2005-06,BOS,2005-06BOS,82,33,49,0.427,19880,2951,6322,2484,5032,467,1290,1664,2204,813,2432,3245,1716,578,422,1359,2033,8033
12,2006-07,BOS,2006-07BOS,82,24,58,0.318,19855,2858,6454,2387,5171,471,1283,1670,2178,918,2391,3309,1630,589,382,1350,1971,7857
11,2007-08,BOS,2007-08BOS,82,66,16,0.805,19755,2986,6286,2390,4722,596,1564,1677,2176,830,2615,3445,1833,696,379,1246,1864,8245
10,2008-09,BOS,2008-09BOS,82,62,20,0.756,19880,3075,6333,2537,4978,538,1355,1587,2075,869,2586,3455,1862,621,387,1280,1897,8275
9,2009-10,BOS,2009-10BOS,82,50,32,0.622,19780,3039,6294,2540,4861,499,1433,1559,2090,716,2449,3165,1930,701,402,1219,1816,8136
8,2010-11,BOS,2010-11BOS,82,56,26,0.683,19780,3023,6219,2615,5100,408,1119,1459,1895,639,2542,3181,1921,676,344,1195,1678,7913
7,2011-12,BOS,2011-12BOS,66,39,27,0.5,15940,2341,5086,1978,4098,363,988,1017,1308,509,2051,2560,1557,498,362,979,1315,6062
6,2012-13,BOS,2012-13BOS,81,41,40,0.512,19840,3001,6459,2503,5069,498,1390,1318,1698,654,2533,3187,1843,667,365,1181,1717,7818
5,2013-14,BOS,2013-14BOS,82,25,57,0.341,19730,2996,6883,2421,5154,575,1729,1325,1706,980,2505,3485,1726,584,343,1261,1743,7892
4,2014-15,BOS,2014-15BOS,82,40,42,0.5,19880,3193,7211,2533,5190,660,2021,1266,1678,910,2685,3595,2009,674,294,1133,1738,8312
3,2015-16,BOS,2015-16BOS,82,48,34,0.606,19780,3216,7318,2499,5176,717,2142,1520,1929,950,2733,3683,1981,752,348,1127,1796,8669
2,2016-17,BOS,2016-17BOS,82,53,29,0.659,19755,3168,6978,2183,4236,985,2742,1536,1903,744,2698,3442,2069,617,340,1088,1686,8857
1,2017-18,BOS,2017-18BOS,7,5,2,0.195,1680,256,585,185,383,71,202,128,169,71,254,325,149,66,33,103,149,711
6,2012-13,BRK,2012-13BRK,82,49,33,0.61,19855,2942,6544,2314,4784,628,1760,1432,1958,1047,2460,3507,1668,599,391,1206,1500,7944
5,2013-14,BRK,2013-14BRK,82,44,38,0.56,19880,2931,6391,2222,4469,709,1922,1508,2002,721,2407,3128,1714,705,311,1191,1777,8079
4,2014-15,BRK,2014-15BRK,82,38,44,0.488,19930,3069,6804,2528,5171,541,1633,1359,1817,846,2627,3473,1716,576,340,1133,1579,8038
3,2015-16,BRK,2015-16BRK,82,21,61,0.293,19755,3136,6920,2605,5412,531,1508,1286,1699,863,2614,3477,1829,627,332,1212,1476,8089
2,2016-17,BRK,2016-17BRK,82,20,62,0.28,19755,3102,6987,2225,4396,877,2591,1592,2020,721,2879,3600,1756,593,387,1356,1726,8673
1,2017-18,BRK,2017-18BRK,7,3,4,0.18,1680,281,632,198,405,83,227,158,208,84,235,319,156,61,28,116,156,803
14,2004-05,CHA,2004-05CHA,82,18,64,0.256,19880,2961,6859,2641,5978,320,881,1487,2096,1083,2335,3418,1794,695,440,1192,1894,7729
13,2005-06,CHA,2005-06CHA,82,26,56,0.341,19905,2961,6843,2533,5582,428,1261,1593,2186,990,2270,3260,1717,822,354,1167,1960,7943
12,2006-07,CHA,2006-07CHA,82,33,49,0.427,20005,2960,6643,2503,5363,457,1280,1568,2136,920,2346,3266,1836,638,369,1224,1985,7945
11,2007-08,CHA,2007-08CHA,82,32,50,0.415,19880,2960,6554,2431,5111,529,1443,1510,2115,892,2440,3332,1748,614,402,1204,1777,7959
10,2008-09,CHA,2008-09CHA,82,35,47,0.451,19930,2866,6299,2376,4960,490,1339,1455,1965,886,2366,3252,1741,580,397,1279,1754,7677
9,2009-10,CHA,2009-10CHA,82,44,38,0.549,19880,2858,6306,2398,4975,460,1331,1637,2180,858,2490,3348,1658,632,446,1290,1597,7813
8,2010-11,CHA,2010-11CHA,82,34,48,0.439,19805,2873,6365,2480,5162,393,1203,1511,1999,848,2444,3292,1728,524,433,1192,1637,7650
7,2011-12,CHA,2011-12CHA,66,7,59,0.207,15890,2193,5293,1930,4401,263,892,1090,1462,677,1894,2571,1326,397,361,957,1249,5739
6,2012-13,CHA,2012-13CHA,82,21,61,0.293,19805,2823,6649,2354,5250,469,1399,1546,2060,917,2389,3306,1587,591,479,1153,1561,7661
5,2013-14,CHA,2013-14CHA,82,43,39,0.54,19905,2976,6730,2460,5259,516,1471,1474,2000,776,2724,3500,1778,499,421,1010,1493,7942
28,1988-89,CHH,1988-89CHH,82,20,62,0.268,19780,3426,7430,3292,7000,134,430,1580,2060,1138,2200,3338,2323,705,264,1318,2068,8566
27,1989-90,CHH,1989-90CHH,82,19,63,0.256,19755,3270,7183,3065,6572,205,611,1487,1967,962,2211,3173,2080,778,262,1226,1889,8232
26,1990-91,CHH,1990-91CHH,82,26,56,0.341,19805,3286,7033,3155,6616,131,417,1725,2214,1027,2200,3227,2019,759,304,1290,1946,8428
25,1991-92,CHH,1991-92CHH,82,31,51,0.402,19805,3613,7568,3496,7199,117,369,1637,2168,1164,2367,3531,2284,822,309,1273,1819,8980
24,1992-93,CHH,1992-93CHH,82,44,38,0.549,19755,3512,7210,3337,6673,175,537,1831,2374,1095,2508,3603,2161,639,473,1325,1790,9030
23,1993-94,CHH,1993-94CHH,82,41,41,0.512,19830,3382,7100,3046,6184,336,916,1632,2135,1019,2475,3494,2214,724,394,1266,1747,8732
22,1994-95,CHH,1994-95CHH,82,50,32,0.622,19805,3051,6438,2491,5029,560,1409,1587,2042,832,2395,3227,2072,620,399,1224,1685,8249
21,1995-96,CHH,1995-96CHH,82,41,41,0.512,19880,3108,6618,2524,5098,584,1520,1631,2119,987,2256,3243,1907,582,277,1241,1815,8431
20,1996-97,CHH,1996-97CHH,82,54,28,0.671,19805,2988,6342,2397,4960,591,1382,1541,1984,910,2298,3208,2021,597,349,1203,1702,8108
19,1997-98,CHH,1997-98CHH,82,51,31,0.634,19780,2968,6344,2622,5440,346,904,1641,2186,985,2341,3326,1941,691,312,1247,1757,7923
18,1998-99,CHH,1998-99CHH,50,26,24,0.341,12150,1671,3718,1403,2983,268,735,1034,1384,480,1493,1973,1110,443,247,796,1101,4644
17,1999-00,CHH,1999-00CHH,82,49,33,0.61,19780,2935,6533,2596,5532,339,1001,1863,2458,884,2635,3519,2023,732,480,1206,1670,8072
16,2000-01,CHH,2000-01CHH,82,46,36,0.573,19880,2800,6501,2460,5517,340,984,1599,2146,1033,2608,3641,1900,665,455,1183,1753,7539
15,2001-02,CHH,2001-02CHH,82,44,38,0.549,19755,2893,6580,2547,5586,346,994,1568,2105,1059,2505,3564,1759,653,456,1150,1747,7700
39,1979-80,CHI,1979-80CHI,82,30,52,0.39,19905,3362,6943,3292,6668,70,275,2019,2592,1115,2465,3580,2152,704,392,1684,2146,8813
38,1980-81,CHI,1980-81CHI,82,45,37,0.561,19780,3457,6903,3419,6724,38,179,1985,2563,1227,2475,3702,1925,729,514,1672,2058,8937
37,1981-82,CHI,1981-82CHI,82,34,48,0.439,19880,3369,6728,3315,6515,54,213,1951,2545,1125,2525,3650,2043,580,483,1636,2008,8743
36,1982-83,CHI,1982-83CHI,82,28,54,0.366,19905,3537,7373,3492,7164,45,209,1983,2690,1267,2527,3794,2086,666,400,1743,2192,9102
35,1983-84,CHI,1983-84CHI,82,27,55,0.354,19980,3305,6972,3285,6855,20,117,1871,2508,1141,2300,3441,2095,687,454,1578,2196,8501
34,1984-85,CHI,1984-85CHI,82,38,44,0.488,19805,3453,6909,3424,6748,29,161,1981,2526,1074,2366,3440,1992,622,468,1463,2071,8916
33,1985-86,CHI,1985-86CHI,82,30,52,0.39,19855,3476,7227,3388,6910,88,317,1922,2499,1280,2278,3558,2006,609,400,1436,2166,8962
32,1986-87,CHI,1986-87CHI,82,40,42,0.5,19830,3382,7155,3304,6856,78,299,1754,2254,1248,2400,3648,2143,677,438,1257,1922,8596
31,1987-88,CHI,1987-88CHI,82,50,32,0.61,19855,3434,7015,3378,6772,56,243,1685,2221,1170,2459,3629,2149,712,475,1263,1849,8609
30,1988-89,CHI,1988-89CHI,82,47,35,0.585,19780,3448,6968,3274,6438,174,530,1656,2106,1018,2453,3471,2213,722,376,1327,1855,8726
29,1989-90,CHI,1989-90CHI,82,55,27,0.671,19830,3531,7090,3281,6421,250,669,1665,2140,1075,2279,3354,2172,814,388,1247,1906,8977
28,1990-91,CHI,1990-91CHI,82,61,21,0.744,19755,3632,7125,3477,6701,155,424,1605,2111,1148,2342,3490,2212,822,438,1184,1751,9024
27,1991-92,CHI,1991-92CHI,82,67,15,0.817,19830,3643,7168,3505,6714,138,454,1587,2132,1173,2439,3612,2279,672,480,1088,1693,9011
26,1992-93,CHI,1992-93CHI,82,57,25,0.695,19830,3475,7205,3231,6536,244,669,1431,1952,1290,2283,3573,2133,783,410,1103,1804,8625
25,1993-94,CHI,1993-94CHI,82,55,27,0.671,19780,3245,6815,3012,6156,233,659,1310,1859,1143,2391,3534,2102,740,354,1306,1750,8033
24,1994-95,CHI,1994-95CHI,82,47,35,0.585,19830,3191,6710,2748,5523,443,1187,1500,2065,1106,2294,3400,1970,797,352,1297,1962,8325
23,1995-96,CHI,1995-96CHI,82,72,10,0.878,19730,3293,6892,2749,5543,544,1349,1495,2004,1247,2411,3658,2033,745,345,1175,1807,8625
22,1996-97,CHI,1996-97CHI,82,69,13,0.841,19730,3277,6923,2754,5520,523,1403,1381,1848,1235,2461,3696,2142,716,332,1109,1617,8458
21,1997-98,CHI,1997-98CHI,82,62,20,0.756,19855,3064,6801,2753,5839,311,962,1492,2009,1243,2438,3681,1952,696,353,1178,1691,7931
20,1998-99,CHI,1998-99CHI,50,13,37,0.207,12075,1539,3837,1362,3225,177,612,840,1185,573,1394,1967,1017,436,169,774,1112,4095
19,1999-00,CHI,1999-00CHI,82,17,65,0.244,19805,2565,6180,2225,5148,340,1032,1482,2089,1032,2323,3355,1645,646,383,1557,1908,6952
18,2000-01,CHI,2000-01CHI,82,15,67,0.22,19855,2721,6411,2392,5461,329,950,1410,1909,926,2260,3186,1810,675,379,1292,1902,7181
17,2001-02,CHI,2001-02CHI,82,21,61,0.28,19805,2811,6491,2511,5623,300,868,1413,1958,924,2359,3283,1817,633,361,1252,1834,7335
16,2002-03,CHI,2002-03CHI,82,30,52,0.39,19930,2991,6714,2642,5717,349,997,1455,2014,985,2541,3526,1782,605,461,1388,2028,7786
15,2003-04,CHI,2003-04CHI,82,23,59,0.305,19830,2798,6753,2369,5497,429,1256,1330,1834,1048,2519,3567,1793,659,396,1321,1911,7355
14,2004-05,CHI,2004-05CHI,82,47,35,0.585,19830,2849,6592,2338,5159,511,1433,1536,2048,1001,2591,3592,1743,576,369,1371,2028,7745
13,2005-06,CHI,2005-06CHI,82,41,41,0.512,19905,3004,6737,2444,5260,560,1477,1452,1967,906,2602,3508,1804,508,345,1224,2038,8020
12,2006-07,CHI,2006-07CHI,82,49,33,0.61,19780,3046,6663,2566,5426,480,1237,1528,2083,984,2597,3581,1832,639,445,1310,1908,8100
11,2007-08,CHI,2007-08CHI,82,33,49,0.427,19805,2987,6861,2513,5556,474,1305,1533,2029,1050,2478,3528,1811,635,429,1197,1784,7981
10,2008-09,CHI,2008-09CHI,82,41,41,0.512,19930,3126,6846,2633,5553,493,1293,1633,2052,970,2481,3451,1732,615,453,1192,1709,8378
9,2009-10,CHI,2009-10CHI,82,41,41,0.512,19905,3081,6825,2729,5759,352,1066,1479,1962,937,2715,3652,1704,531,478,1175,1648,7993
8,2010-11,CHI,2010-11CHI,82,62,20,0.756,19830,3042,6587,2531,5172,511,1415,1492,2008,967,2654,3621,1827,592,468,1161,1639,8087
7,2011-12,CHI,2011-12CHI,66,50,16,0.621,15940,2467,5462,2048,4345,419,1117,1006,1394,915,2165,3080,1527,456,388,923,1139,6359
6,2012-13,CHI,2012-13CHI,82,45,37,0.561,19830,2926,6698,2480,5433,446,1265,1343,1738,1026,2514,3540,1886,588,417,1171,1617,7641
5,2013-14,CHI,2013-14CHI,82,48,34,0.598,19930,2843,6577,2335,5118,508,1459,1486,1908,937,2683,3620,1860,594,424,1223,1565,7680
4,2014-15,CHI,2014-15CHI,82,50,32,0.625,19880,3001,6797,2356,4972,645,1825,1618,2067,959,2792,3751,1781,514,476,1145,1495,8265
3,2015-16,CHI,2015-16CHI,82,42,40,0.537,19905,3165,7170,2514,5417,651,1753,1354,1720,907,2889,3796,1870,495,470,1141,1545,8335
2,2016-17,CHI,2016-17CHI,82,41,41,0.512,19780,3169,7141,2546,5310,623,1831,1474,1848,999,2797,3796,1851,643,393,1112,1455,8435
1,2017-18,CHI,2017-18CHI,5,1,4,0.122,1200,163,423,111,261,52,162,71,90,56,179,235,104,27,19,87,89,449
4,2014-15,CHO,2014-15CHO,82,33,49,0.427,19905,2913,6932,2415,5366,498,1566,1397,1867,820,2793,3613,1654,499,448,976,1494,7721
3,2015-16,CHO,2015-16CHO,82,48,34,0.61,19855,3036,6922,2163,4512,873,2410,1534,1941,734,2869,3603,1778,595,438,1030,1487,8479
2,2016-17,CHO,2016-17CHO,82,36,46,0.463,19830,3093,7000,2269,4653,824,2347,1591,1953,721,2853,3574,1891,571,390,942,1360,8601
1,2017-18,CHO,2017-18CHO,7,4,3,0.183,1680,260,592,196,406,64,186,136,195,67,293,360,130,32,36,103,130,720
39,1979-80,CLE,1979-80CLE,82,37,45,0.476,19930,3811,8041,3775,7854,36,187,1702,2205,1307,2381,3688,2108,764,342,1370,1934,9360
38,1980-81,CLE,1980-81CLE,82,28,54,0.366,19780,3556,7609,3484,7360,72,249,1486,1909,1258,2243,3501,2007,632,322,1396,1995,8670
37,1981-82,CLE,1981-82CLE,82,15,67,0.22,19805,3405,7334,3380,7197,25,137,1628,2179,1190,2170,3360,1871,634,357,1319,2193,8463
36,1982-83,CLE,1982-83CLE,82,23,59,0.305,19755,3252,6995,3222,6875,30,120,1430,1983,1173,2414,3587,1738,617,290,1538,2236,7964
35,1983-84,CLE,1983-84CLE,82,28,54,0.354,19855,3362,7232,3319,7068,43,164,1619,2178,1213,2388,3601,1930,630,375,1332,2206,8386
34,1984-85,CLE,1984-85CLE,82,36,46,0.451,19780,3470,7364,3374,7029,96,335,1867,2491,1203,2445,3648,2096,622,472,1387,2173,8903
33,1985-86,CLE,1985-86CLE,82,29,53,0.378,19780,3478,7239,3346,6848,132,391,1748,2325,1086,2455,3541,2064,627,436,1411,2267,8836
32,1986-87,CLE,1986-87CLE,82,31,51,0.402,19755,3349,7122,3268,6784,81,338,1779,2554,1257,2420,3677,1912,672,559,1619,1853,8558
31,1987-88,CLE,1987-88CLE,82,42,40,0.524,19780,3313,6755,3186,6419,127,336,1813,2438,1015,2289,3304,2070,733,526,1439,1836,8566
30,1988-89,CLE,1988-89CLE,82,57,25,0.695,19755,3466,6904,3296,6430,170,474,1821,2438,1033,2475,3508,2260,791,586,1323,1592,8923
29,1989-90,CLE,1989-90CLE,82,42,40,0.524,19880,3214,6977,2868,6126,346,851,1637,2201,1128,2380,3508,2106,645,512,1243,1666,8411
28,1990-91,CLE,1990-91CLE,82,33,49,0.415,19830,3259,6857,3099,6378,160,479,1665,2176,1011,2329,3340,2240,643,450,1281,1672,8343
27,1991-92,CLE,1991-92CLE,82,57,25,0.695,19805,3427,7025,3174,6317,253,708,1819,2259,1041,2450,3491,2260,616,621,1073,1556,8926
26,1992-93,CLE,1992-93CLE,82,54,28,0.667,19830,3425,6887,3142,6145,283,742,1699,2119,929,2496,3425,2349,615,536,1120,1580,8832
25,1993-94,CLE,1993-94CLE,82,47,35,0.585,19855,3133,6731,2839,5918,294,813,1736,2254,1090,2353,3443,2049,705,426,1136,1701,8296
24,1994-95,CLE,1994-95CLE,82,43,39,0.537,19930,2756,6255,2358,5222,398,1033,1507,1982,1045,2237,3282,1672,630,349,1176,1694,7417
23,1995-96,CLE,1995-96CLE,82,47,35,0.591,19830,2761,5998,2165,4416,596,1582,1355,1775,867,2055,2922,1818,674,340,1073,1685,7473
22,1996-97,CLE,1996-97CLE,82,42,40,0.537,19855,2704,5972,2221,4688,483,1284,1282,1773,909,2159,3068,1714,655,315,1188,1882,7173
21,1997-98,CLE,1997-98CLE,82,47,35,0.585,19830,2817,6207,2519,5406,298,801,1653,2187,955,2331,3286,1894,814,419,1418,1939,7585
20,1998-99,CLE,1998-99CLE,50,22,28,0.293,12050,1562,3561,1380,3027,182,534,1016,1356,472,1316,1788,1093,452,203,785,1208,4322
19,1999-00,CLE,1999-00CLE,82,32,50,0.415,19855,2977,6734,2634,5815,343,919,1653,2205,1010,2499,3509,1941,715,363,1427,2219,7950
18,2000-01,CLE,2000-01CLE,82,30,52,0.39,19830,2890,6532,2670,5873,220,659,1561,2040,1015,2440,3455,1708,642,436,1350,1904,7561
17,2001-02,CLE,2001-02CLE,82,29,53,0.378,19855,2948,6582,2561,5556,387,1026,1529,1980,968,2483,3451,1891,572,470,1196,1752,7812
16,2002-03,CLE,2002-03CLE,82,17,65,0.244,19830,2850,6746,2557,5850,293,896,1502,2012,1118,2542,3660,1712,636,521,1501,1864,7495
15,2003-04,CLE,2003-04CLE,82,35,47,0.451,19855,2922,6753,2675,5967,247,786,1528,2030,1118,2619,3737,1808,585,537,1216,1743,7619
14,2004-05,CLE,2004-05CLE,82,42,40,0.524,19855,2990,6687,2690,5783,300,904,1634,2174,1117,2352,3469,1851,654,461,1141,1850,7914
13,2005-06,CLE,2005-06CLE,82,50,32,0.622,19830,2908,6412,2411,4947,497,1465,1689,2318,959,2511,3470,1560,567,392,1137,1733,8002
12,2006-07,CLE,2006-07CLE,82,50,32,0.622,19880,2978,6658,2484,5254,494,1404,1484,2133,1039,2529,3568,1708,625,353,1177,1781,7934
11,2007-08,CLE,2007-08CLE,82,45,37,0.573,19855,2937,6697,2385,5153,552,1544,1477,2061,1092,2563,3655,1640,579,427,1145,1712,7903
10,2008-09,CLE,2008-09CLE,82,66,16,0.805,19780,3022,6454,2366,4784,656,1670,1523,2012,886,2574,3460,1663,593,435,1045,1663,8223
9,2009-10,CLE,2009-10CLE,82,61,21,0.744,19780,3101,6391,2499,4809,602,1582,1569,2180,791,2692,3483,1835,564,425,1137,1591,8373
8,2010-11,CLE,2010-11CLE,82,19,63,0.268,19755,2886,6647,2377,5158,509,1489,1546,2075,856,2449,3305,1720,544,341,1166,1648,7827
7,2011-12,CLE,2011-12CLE,66,21,45,0.293,15965,2261,5360,1821,4087,440,1273,1178,1645,841,1949,2790,1308,466,262,1017,1317,6140
6,2012-13,CLE,2012-13CLE,82,24,58,0.329,19730,2993,6901,2446,5320,547,1581,1380,1826,1004,2359,3363,1694,647,334,1149,1737,7913
5,2013-14,CLE,2013-14CLE,82,33,49,0.427,19930,3036,6955,2452,5315,584,1640,1398,1861,989,2629,3618,1738,579,304,1163,1640,8054
4,2014-15,CLE,2014-15CLE,82,53,29,0.659,19780,3089,6739,2263,4486,826,2253,1453,1934,911,2612,3523,1814,603,340,1171,1510,8457
3,2015-16,CLE,2015-16CLE,82,57,25,0.707,19855,3171,6888,2291,4460,880,2428,1333,1783,873,2777,3650,1861,551,317,1114,1666,8555
2,2016-17,CLE,2016-17CLE,82,51,31,0.634,19880,3275,6963,2208,4184,1067,2779,1431,1913,766,2821,3587,1858,539,327,1121,1486,9048
1,2017-18,CLE,2017-18CLE,7,3,4,0.171,1680,264,573,191,362,73,211,132,167,58,244,302,147,38,31,112,122,733
38,1980-81,DAL,1980-81DAL,82,15,67,0.22,19780,3204,6928,3158,6763,46,165,1868,2487,1109,2177,3286,1984,561,214,1439,2008,8322
37,1981-82,DAL,1981-82DAL,82,28,54,0.36,19730,3390,7224,3335,7034,55,190,1740,2366,1213,2228,3441,2117,566,313,1317,2193,8575
36,1982-83,DAL,1982-83DAL,82,38,44,0.488,19730,3674,7550,3631,7365,43,185,1852,2462,1296,2381,3677,2227,552,348,1348,2067,9243
35,1983-84,DAL,1983-84DAL,82,43,39,0.537,19955,3618,7235,3576,7051,42,184,1774,2350,1090,2265,3355,2164,579,360,1303,1906,9052
34,1984-85,DAL,1984-85DAL,82,44,38,0.549,19855,3560,7280,3408,6837,152,443,1844,2324,1095,2345,3440,2152,575,335,1184,1796,9116
33,1985-86,DAL,1985-86DAL,82,44,38,0.549,19805,3631,7254,3490,6808,141,446,2050,2643,1059,2454,3513,2108,605,369,1289,1733,9453
32,1986-87,DAL,1986-87DAL,82,55,27,0.671,19880,3594,7373,3363,6720,231,653,2148,2717,1219,2494,3713,2017,688,424,1205,1873,9567
31,1987-88,DAL,1987-88DAL,82,53,29,0.659,19755,3413,7191,3259,6665,154,526,1980,2510,1341,2495,3836,1984,645,446,1257,1734,8960
30,1988-89,DAL,1988-89DAL,82,38,44,0.488,19780,3244,6917,3033,6236,211,681,1785,2263,1048,2397,3445,1867,579,476,1233,1739,8484
29,1989-90,DAL,1989-90DAL,82,47,35,0.585,19855,3246,6831,3089,6345,157,486,1735,2261,1042,2419,3461,1776,664,398,1228,1733,8384
28,1990-91,DAL,1990-91DAL,82,28,54,0.366,19805,3245,6890,3052,6290,193,600,1512,1986,984,2360,3344,1821,581,397,1186,1840,8195
27,1991-92,DAL,1991-92DAL,82,22,60,0.293,19755,3120,7104,2852,6307,268,797,1499,1999,1194,2439,3633,1630,536,349,1202,1867,8007
26,1992-93,DAL,1992-93DAL,82,11,71,0.207,19730,3164,7271,2881,6434,283,837,1530,2171,1234,2265,3499,1683,649,355,1459,2302,8141
25,1993-94,DAL,1993-94DAL,82,13,69,0.207,19730,3055,7070,2814,6297,241,773,1450,1942,1271,2150,3421,1629,767,299,1393,2007,7801
24,1994-95,DAL,1994-95DAL,82,36,46,0.463,19930,3227,7342,2841,6142,386,1200,1622,2210,1514,2433,3947,1941,579,348,1345,1811,8462
23,1995-96,DAL,1995-96DAL,82,26,56,0.348,19930,3124,7431,2389,5392,735,2039,1426,1975,1408,2379,3787,1913,642,342,1270,1836,8409
22,1996-97,DAL,1996-97DAL,82,24,58,0.318,19805,2813,6452,2383,5136,430,1316,1375,1918,1040,2262,3302,1663,654,351,1324,1798,7431
21,1997-98,DAL,1997-98DAL,82,20,62,0.28,19905,2882,6754,2460,5571,422,1183,1308,1738,1008,2280,3288,1535,646,466,1182,1643,7494
20,1998-99,DAL,1998-99DAL,50,19,31,0.256,12075,1749,4033,1547,3438,202,595,881,1210,645,1478,2123,921,352,292,692,1065,4581
19,1999-00,DAL,1999-00DAL,82,40,42,0.5,19730,3195,7047,2676,5721,519,1326,1407,1751,931,2444,3375,1810,592,416,1124,1770,8316
18,2000-01,DAL,2000-01DAL,82,53,29,0.659,19805,3085,6716,2568,5359,517,1357,1552,1954,831,2571,3402,1740,618,492,1141,1907,8239
17,2001-02,DAL,2001-02DAL,82,57,25,0.707,19880,3200,6930,2579,5285,621,1645,1608,1994,918,2568,3486,1811,581,392,992,1842,8629
16,2002-03,DAL,2002-03DAL,82,60,22,0.744,19780,3161,6982,2525,5314,636,1668,1486,1793,912,2544,3456,1837,665,449,949,1730,8444
15,2003-04,DAL,2003-04DAL,82,52,30,0.646,19805,3322,7230,2815,5774,507,1456,1475,1854,1174,2538,3712,1963,656,437,1000,1609,8626
14,2004-05,DAL,2004-05DAL,82,58,24,0.714,19730,3058,6691,2595,5418,463,1273,1826,2314,990,2530,3520,1610,708,461,1102,1827,8405
13,2005-06,DAL,2005-06DAL,82,60,22,0.732,19880,2948,6375,2532,5262,416,1113,1818,2322,1030,2431,3461,1473,593,488,1112,1834,8130
12,2006-07,DAL,2006-07DAL,82,67,15,0.817,19755,3010,6442,2475,5038,535,1404,1646,2045,920,2515,3435,1632,560,408,1140,1837,8201
11,2007-08,DAL,2007-08DAL,82,51,31,0.634,19730,3025,6515,2531,5112,494,1403,1690,2075,883,2643,3526,1720,490,402,1037,1786,8234
10,2008-09,DAL,2008-09DAL,82,50,32,0.622,19805,3128,6770,2557,5138,571,1632,1516,1852,909,2595,3504,1779,591,429,1043,1600,8343
9,2009-10,DAL,2009-10DAL,82,55,27,0.683,19880,3140,6760,2582,5262,558,1498,1526,1870,834,2586,3420,1917,624,449,1059,1563,8364
8,2010-11,DAL,2010-11DAL,82,57,25,0.707,19705,3069,6463,2424,4695,645,1768,1437,1850,780,2618,3398,1954,557,352,1145,1575,8220
7,2011-12,DAL,2011-12DAL,66,36,30,0.463,16065,2398,5412,1901,3948,497,1464,1029,1334,665,2157,2822,1380,565,337,926,1226,6322
6,2012-13,DAL,2012-13DAL,82,41,41,0.512,19980,3182,6892,2576,5264,606,1628,1323,1669,767,2670,3437,1906,648,454,1144,1698,8293
5,2013-14,DAL,2013-14DAL,82,49,33,0.61,19830,3249,6858,2528,4981,721,1877,1378,1733,840,2514,3354,1935,704,356,1110,1636,8597
4,2014-15,DAL,2014-15DAL,82,50,32,0.634,19880,3255,7036,2523,4954,732,2082,1386,1843,858,2608,3466,1846,663,371,1062,1644,8628
3,2015-16,DAL,2015-16DAL,82,42,40,0.537,20005,3064,6900,2258,4558,806,2342,1454,1831,751,2781,3532,1813,560,306,1047,1595,8388
2,2016-17,DAL,2016-17DAL,82,33,49,0.429,19780,2968,6750,2090,4277,878,2473,1215,1516,647,2516,3163,1705,614,307,972,1567,8029
1,2017-18,DAL,2017-18DAL,8,1,7,0.134,1920,278,659,176,397,102,262,128,172,72,251,323,165,57,22,121,144,786
39,1979-80,DEN,1979-80DEN,82,30,52,0.39,19830,3462,7470,3379,7215,83,255,1871,2539,1311,2524,3835,2079,746,404,1533,1917,8878
38,1980-81,DEN,1980-81DEN,82,37,45,0.47,19955,3784,7960,3754,7815,30,145,2388,3051,1325,2497,3822,2030,720,380,1444,2108,9986
37,1981-82,DEN,1981-82DEN,82,46,36,0.573,19830,3980,7656,3940,7507,40,149,2371,2978,1149,2443,3592,2272,664,368,1470,2131,10371
36,1982-83,DEN,1982-83DEN,82,45,37,0.561,19730,3951,7999,3927,7873,24,126,2179,2696,1214,2524,3738,2336,789,352,1496,2091,10105
35,1983-84,DEN,1983-84DEN,82,38,44,0.488,19805,3935,7983,3858,7728,77,255,2200,2690,1133,2444,3577,2482,711,352,1344,2279,10147
34,1984-85,DEN,1984-85DEN,82,52,30,0.646,19830,3876,7976,3803,7741,73,235,2016,2568,1331,2303,3634,2266,894,424,1382,2152,9841
33,1985-86,DEN,1985-86DEN,82,47,35,0.576,19755,3705,7868,3634,7563,71,305,1929,2416,1223,2317,3540,2140,826,421,1336,2164,9410
32,1986-87,DEN,1986-87DEN,82,37,45,0.476,19780,3744,7951,3638,7560,106,391,1975,2568,1294,2368,3662,2317,754,421,1216,2184,9569
31,1987-88,DEN,1987-88DEN,82,54,28,0.66,19780,3770,7961,3578,7399,192,562,1841,2289,1163,2442,3605,2300,832,401,1186,1982,9573
30,1988-89,DEN,1988-89DEN,82,44,38,0.549,19880,3813,8140,3585,7464,228,676,1821,2314,1206,2513,3719,2282,811,436,1225,2088,9675
29,1989-90,DEN,1989-90DEN,82,43,39,0.537,19805,3716,8015,3488,7338,228,677,1737,2201,1169,2532,3701,2275,814,329,1136,2047,9397
28,1990-91,DEN,1990-91DEN,82,20,62,0.28,19730,3901,8868,3601,7809,300,1059,1726,2263,1520,2530,4050,2005,856,406,1332,2235,9828
27,1991-92,DEN,1991-92DEN,82,24,58,0.317,19780,3262,7380,3136,6962,126,418,1526,2067,1350,2352,3702,1553,773,461,1447,1984,8176
26,1992-93,DEN,1992-93DEN,82,36,46,0.451,19830,3352,7282,3214,6828,138,454,1784,2360,1266,2564,3830,1735,651,565,1413,2039,8626
25,1993-94,DEN,1993-94DEN,82,42,40,0.524,19755,3156,6781,2986,6184,170,597,1739,2423,1105,2557,3662,1763,679,686,1422,1926,8221
24,1994-95,DEN,1994-95DEN,82,41,41,0.512,19980,3098,6461,2685,5301,413,1160,1700,2305,1040,2402,3442,1836,660,585,1381,2063,8309
23,1995-96,DEN,1995-96DEN,82,35,47,0.451,19830,3001,6657,2604,5509,397,1148,1614,2173,1057,2487,3544,1851,521,597,1265,1882,8013
22,1996-97,DEN,1996-97DEN,82,21,61,0.293,19930,2934,6687,2298,4976,636,1711,1516,1992,994,2452,3446,1889,503,487,1359,1784,8020
21,1997-98,DEN,1997-98DEN,82,11,71,0.207,19730,2677,6412,2389,5519,288,893,1658,2147,1040,2157,3197,1547,664,393,1311,1937,7300
20,1998-99,DEN,1998-99DEN,50,14,36,0.207,12025,1681,3989,1379,3067,302,922,1010,1325,647,1392,2039,969,376,275,739,1145,4674
19,1999-00,DEN,1999-00DEN,82,35,47,0.451,19855,3057,6911,2587,5514,470,1397,1531,2116,1073,2590,3663,1911,554,618,1281,1962,8115
18,2000-01,DEN,2000-01DEN,82,40,42,0.5,19780,2979,6877,2467,5433,512,1444,1448,1964,1044,2583,3627,1970,552,538,1136,1820,7918
17,2001-02,DEN,2001-02DEN,82,27,55,0.354,19805,2915,6870,2492,5585,423,1285,1306,1756,1117,2310,3427,1817,613,462,1205,1873,7559
16,2002-03,DEN,2002-03DEN,82,17,65,0.244,19730,2689,6544,2460,5720,229,824,1294,1850,1112,2363,3475,1737,712,422,1514,2056,6901
15,2003-04,DEN,2003-04DEN,82,43,39,0.537,19730,2993,6763,2662,5778,331,985,1655,2159,1083,2387,3470,1794,745,520,1278,1804,7972
14,2004-05,DEN,2004-05DEN,82,49,33,0.61,19755,3038,6615,2718,5675,320,940,1765,2313,967,2473,3440,1958,750,489,1224,1878,8161
13,2005-06,DEN,2005-06DEN,82,44,38,0.549,19930,3078,6672,2728,5596,350,1076,1721,2312,903,2486,3389,1921,698,463,1216,1863,8227
12,2006-07,DEN,2006-07DEN,82,45,37,0.571,19780,3164,6805,2680,5365,484,1440,1827,2449,1001,2558,3559,1920,678,435,1352,1756,8639
11,2007-08,DEN,2007-08DEN,82,50,32,0.622,19855,3307,7038,2738,5433,569,1605,1891,2519,918,2698,3616,2024,752,551,1203,1731,9074
10,2008-09,DEN,2008-09DEN,82,54,28,0.671,19730,3058,6510,2510,5033,548,1477,1891,2487,905,2507,3412,1820,710,492,1257,1874,8555
9,2009-10,DEN,2009-10DEN,82,53,29,0.659,19780,3124,6678,2580,5161,544,1517,1937,2508,889,2505,3394,1719,683,417,1136,1844,8729
8,2010-11,DEN,2010-11DEN,82,50,32,0.625,19705,3145,6613,2483,4909,662,1704,1859,2429,791,2652,3443,1813,605,352,1157,1719,8811
7,2011-12,DEN,2011-12DEN,66,38,28,0.488,16040,2572,5404,2137,4093,435,1311,1293,1760,738,2105,2843,1581,540,330,1015,1297,6872
6,2012-13,DEN,2012-13DEN,82,57,25,0.707,19905,3339,6983,2818,5465,521,1518,1505,2148,1092,2601,3693,2002,762,533,1253,1682,8704
5,2013-14,DEN,2013-14DEN,82,36,46,0.463,19755,3147,7042,2445,5083,702,1959,1563,2154,1009,2717,3726,1838,615,459,1305,1890,8559
4,2014-15,DEN,2014-15DEN,82,30,52,0.402,19880,3099,7158,2439,5126,660,2032,1462,1991,1012,2653,3665,1788,641,367,1166,1882,8320
3,2015-16,DEN,2015-16DEN,82,33,49,0.429,19830,3093,7003,2437,5060,656,1943,1513,1974,941,2718,3659,1858,609,395,1202,1723,8355
2,2016-17,DEN,2016-17DEN,82,40,42,0.5,19755,3377,7194,2507,4829,870,2365,1537,1986,966,2837,3803,2077,568,323,1226,1567,9161
1,2017-18,DEN,2017-18DEN,7,3,4,0.16,1680,274,611,202,419,72,192,108,146,79,239,318,158,50,24,106,138,728
39,1979-80,DET,1979-80DET,82,16,66,0.232,19780,3643,7596,3586,7377,57,219,1590,2149,1226,2415,3641,1950,783,562,1742,2069,8933
38,1980-81,DET,1980-81DET,82,21,61,0.28,19755,3236,6986,3223,6902,13,84,1689,2330,1201,2111,3312,1819,884,492,1759,2125,8174
37,1981-82,DET,1981-82DET,82,39,43,0.488,19830,3561,7391,3509,7178,52,213,1938,2581,1298,2345,3643,2027,741,564,1629,2160,9112
36,1982-83,DET,1982-83DET,82,37,45,0.476,19880,3623,7602,3551,7330,72,272,1921,2588,1312,2477,3789,2108,679,572,1557,2122,9239
35,1983-84,DET,1983-84DET,82,49,33,0.61,19905,3798,7910,3766,7769,32,141,1974,2547,1427,2434,3861,2256,697,417,1310,2177,9602
34,1984-85,DET,1984-85DET,82,46,36,0.573,19830,3840,7999,3795,7800,45,199,1783,2262,1403,2534,3937,2302,691,397,1341,2076,9508
33,1985-86,DET,1985-86DET,82,46,36,0.573,19780,3754,7750,3699,7568,55,182,1800,2300,1276,2461,3737,2319,738,340,1343,2101,9363
32,1986-87,DET,1986-87DET,82,52,30,0.646,19830,3544,7237,3505,7068,39,169,1991,2602,1245,2649,3894,2021,643,436,1417,2078,9118
31,1987-88,DET,1987-88DET,82,54,28,0.659,19780,3461,7018,3403,6816,58,202,1977,2612,1181,2482,3663,2011,588,394,1348,1957,8957
30,1988-89,DET,1988-89DET,82,63,19,0.768,19830,3395,6879,3275,6479,120,400,1830,2379,1154,2546,3700,2027,522,406,1336,1939,8740
29,1989-90,DET,1989-90DET,82,59,23,0.72,19805,3333,6980,3156,6439,177,541,1713,2252,1185,2458,3643,1996,512,418,1233,1961,8556
28,1990-91,DET,1990-91DET,82,50,32,0.61,19805,3194,6875,3063,6435,131,440,1686,2211,1206,2452,3658,1825,487,367,1181,1869,8205
27,1991-92,DET,1991-92DET,82,48,34,0.598,19780,3191,6867,3026,6341,165,526,1566,2108,1210,2421,3631,1899,546,357,1212,1646,8113
26,1992-93,DET,1992-93DET,82,40,42,0.5,19780,3267,7211,2975,6303,292,908,1426,1957,1293,2315,3608,1941,580,249,1152,1747,8252
25,1993-94,DET,1993-94DET,82,20,62,0.268,19730,3169,7017,2811,5976,358,1041,1253,1715,1027,2320,3347,1767,602,309,1236,1935,7949
24,1994-95,DET,1994-95DET,82,28,54,0.366,19730,3060,6633,2566,5237,494,1396,1439,1941,958,2204,3162,1872,705,420,1318,2151,8053
23,1995-96,DET,1995-96DET,82,46,36,0.573,19830,2810,6122,2265,4772,545,1350,1657,2206,884,2440,3324,1610,506,352,1215,1953,7822
22,1996-97,DET,1996-97DET,82,54,28,0.671,19830,2827,6095,2245,4596,582,1499,1487,1995,858,2292,3150,1554,632,283,1041,1652,7723
21,1997-98,DET,1997-98DET,82,37,45,0.476,19955,2862,6373,2569,5435,293,938,1704,2288,1044,2338,3382,1597,678,344,1198,1805,7721
20,1998-99,DET,1998-99DET,50,29,21,0.378,12050,1660,3716,1412,3037,248,679,950,1283,605,1412,2017,1009,444,208,790,1139,4518
19,1999-00,DET,1999-00DET,82,42,40,0.537,19830,3044,6635,2605,5412,439,1223,1956,2506,917,2458,3375,1707,665,273,1288,2011,8483
18,2000-01,DET,2000-01DET,82,32,50,0.415,19855,2919,6880,2530,5768,389,1112,1610,2233,1108,2626,3734,1629,613,447,1304,1955,7837
17,2001-02,DET,2001-02DET,82,50,32,0.622,19680,2845,6300,2278,4791,567,1509,1478,1954,810,2366,3176,1765,648,565,1193,1695,7735
16,2002-03,DET,2002-03DET,82,50,32,0.622,19905,2700,6277,2167,4789,533,1488,1559,2021,883,2445,3328,1620,556,468,1104,1748,7492
15,2003-04,DET,2003-04DET,82,54,28,0.667,19780,2747,6314,2414,5346,333,968,1561,2074,1014,2492,3506,1702,659,570,1241,1664,7388
14,2004-05,DET,2004-05DET,82,54,28,0.667,19955,2851,6421,2488,5368,363,1053,1588,2150,1054,2507,3561,1787,576,497,1133,1638,7653
13,2005-06,DET,2005-06DET,82,64,18,0.78,19830,2983,6558,2426,5107,557,1451,1418,1950,975,2347,3322,1971,580,490,931,1513,7941
12,2006-07,DET,2006-07DET,82,53,29,0.659,19880,2942,6484,2493,5179,449,1305,1539,1988,948,2374,3322,1768,583,472,1001,1672,7872
11,2007-08,DET,2007-08DET,82,59,23,0.72,19730,2999,6551,2512,5221,487,1330,1507,1965,974,2423,3397,1831,583,472,956,1688,7992
10,2008-09,DET,2008-09DET,82,39,43,0.5,19905,2981,6559,2604,5480,377,1079,1388,1849,949,2448,3397,1689,493,377,973,1712,7727
9,2009-10,DET,2009-10DET,82,27,55,0.354,19780,2940,6602,2566,5412,374,1190,1455,1998,1053,2242,3295,1591,596,313,1100,1822,7709
8,2010-11,DET,2010-11DET,82,30,52,0.39,19880,3056,6647,2584,5391,472,1256,1367,1854,931,2236,3167,1730,595,328,1067,1629,7951
7,2011-12,DET,2011-12DET,66,25,41,0.329,15965,2291,5232,1974,4316,317,916,1098,1461,775,1882,2657,1232,460,278,1033,1293,5997
6,2012-13,DET,2012-13DET,82,29,53,0.378,19805,2979,6638,2466,5198,513,1440,1307,1870,991,2463,3454,1742,574,400,1241,1623,7778
5,2013-14,DET,2013-14DET,82,29,53,0.378,19780,3182,7124,2675,5544,507,1580,1415,2111,1196,2525,3721,1714,687,395,1193,1666,8286
4,2014-15,DET,2014-15DET,82,32,50,0.415,19830,3041,7038,2338,4995,703,2043,1292,1838,1051,2630,3681,1771,623,383,1099,1559,8077
3,2015-16,DET,2015-16DET,82,44,38,0.56,19880,3111,7087,2371,4939,740,2148,1399,2095,1021,2777,3798,1594,573,304,1110,1557,8361
2,2016-17,DET,2016-17DET,82,37,45,0.476,19805,3269,7282,2638,5367,631,1915,1140,1586,908,2838,3746,1732,574,310,973,1467,8309
1,2017-18,DET,2017-18DET,7,5,2,0.183,1680,288,632,218,434,70,198,96,121,84,212,296,148,70,17,97,150,742
39,1979-80,GSW,1979-80GSW,82,24,58,0.317,19880,3527,7318,3500,7197,27,121,1412,1914,1155,2437,3592,2028,779,339,1492,2082,8493
38,1980-81,GSW,1980-81GSW,82,39,43,0.488,19730,3560,7284,3500,7074,60,210,1826,2513,1403,2366,3769,2026,611,301,1547,2158,9006
37,1981-82,GSW,1981-82GSW,82,45,37,0.561,19780,3646,7349,3555,7024,91,325,1709,2382,1282,2452,3734,1820,685,391,1424,2225,9092
36,1982-83,GSW,1982-83GSW,82,30,52,0.38,19780,3627,7508,3593,7358,34,150,1620,2199,1281,2284,3565,1964,856,430,1606,2138,8908
35,1983-84,GSW,1983-84GSW,82,37,45,0.476,19830,3519,7534,3464,7308,55,226,1915,2577,1390,2171,3561,1837,830,348,1518,2108,9008
34,1984-85,GSW,1984-85GSW,82,22,60,0.293,19855,3498,7555,3386,7158,112,397,1944,2531,1327,2139,3466,1759,803,284,1460,2136,9052
33,1985-86,GSW,1985-86GSW,82,30,52,0.39,19780,3650,7567,3563,7289,87,278,1912,2517,1271,2344,3615,2018,751,354,1400,2032,9299
32,1986-87,GSW,1986-87GSW,82,42,40,0.524,19905,3551,7412,3435,7048,116,364,1970,2526,1193,2351,3544,2083,715,321,1354,2138,9188
31,1987-88,GSW,1987-88GSW,82,20,62,0.268,19780,3463,7404,3372,7092,91,312,1754,2204,1140,2252,3392,2005,741,283,1395,2155,8771
30,1988-89,GSW,1988-89GSW,82,43,39,0.537,19905,3730,7977,3536,7348,194,629,1904,2384,1323,2561,3884,2009,831,643,1488,1946,9558
29,1989-90,GSW,1989-90GSW,82,37,45,0.476,19705,3489,7208,3246,6458,243,750,2313,2858,915,2385,3300,1978,756,488,1415,2010,9534
28,1990-91,GSW,1990-91GSW,82,44,38,0.549,19805,3566,7346,3296,6545,270,801,2162,2761,1113,2306,3419,1954,803,378,1359,2207,9564
27,1991-92,GSW,1991-92GSW,82,55,27,0.671,19880,3767,7427,3513,6664,254,763,1944,2606,1137,2376,3513,2064,854,375,1353,2049,9732
26,1992-93,GSW,1992-93GSW,82,34,48,0.439,19905,3474,7212,3176,6360,298,852,1768,2465,1219,2384,3603,2010,693,383,1451,2056,9014
25,1993-94,GSW,1993-94GSW,82,50,32,0.61,19780,3512,7145,3221,6286,291,859,1529,2304,1183,2396,3579,2198,804,511,1433,1789,8844
24,1994-95,GSW,1994-95GSW,82,26,56,0.341,19905,3217,6873,2671,5271,546,1602,1687,2395,1101,2371,3472,2017,649,391,1497,1804,8667
23,1995-96,GSW,1995-96GSW,82,36,46,0.463,19755,3056,6700,2609,5501,447,1199,1775,2340,1173,2285,3458,1889,706,470,1343,1835,8334
22,1996-97,GSW,1996-97GSW,82,30,52,0.39,19905,2997,6567,2516,5204,481,1363,1696,2180,1086,2259,3345,1822,611,359,1410,1787,8171
21,1997-98,GSW,1997-98GSW,82,19,63,0.256,19830,2845,6883,2656,6187,189,696,1358,1912,1288,2473,3761,1708,621,448,1369,1859,7237
20,1998-99,GSW,1998-99GSW,50,21,29,0.28,12125,1730,4173,1568,3608,162,565,794,1175,816,1559,2375,1037,414,221,768,1270,4416
19,1999-00,GSW,1999-00GSW,82,19,63,0.26,19755,2996,7140,2651,6071,345,1069,1497,2147,1300,2438,3738,1851,731,356,1302,2043,7834
18,2000-01,GSW,2000-01GSW,82,17,65,0.244,19780,2937,7175,2655,6211,282,964,1428,2024,1345,2385,3730,1788,742,410,1301,1727,7584
17,2001-02,GSW,2001-02GSW,82,21,61,0.28,19780,2998,6989,2678,5995,320,994,1693,2344,1334,2493,3827,1706,650,523,1378,1884,8009
16,2002-03,GSW,2002-03GSW,82,38,44,0.488,19755,3061,6941,2636,5706,425,1235,1853,2382,1284,2546,3830,1712,594,506,1295,1786,8400
15,2003-04,GSW,2003-04GSW,82,37,45,0.476,19855,2875,6511,2446,5228,429,1283,1470,2028,1002,2533,3535,1681,576,389,1211,1691,7649
14,2004-05,GSW,2004-05GSW,82,34,48,0.439,19905,3029,7039,2405,5265,624,1774,1412,1955,1069,2436,3505,1811,642,420,1112,1833,8094
13,2005-06,GSW,2005-06GSW,82,34,48,0.439,19830,2939,6785,2314,4953,625,1832,1573,2190,980,2485,3465,1694,604,357,1156,1941,8076
12,2006-07,GSW,2006-07GSW,82,42,40,0.537,19755,3261,7048,2561,5081,700,1967,1515,2113,940,2456,3396,1950,750,466,1309,1933,8737
11,2007-08,GSW,2007-08GSW,82,48,34,0.606,19780,3403,7406,2642,5221,761,2185,1538,2044,1045,2496,3541,1833,744,377,1082,1875,9105
10,2008-09,GSW,2008-09GSW,82,29,53,0.378,19880,3231,7055,2681,5580,550,1475,1893,2392,953,2492,3445,1711,638,527,1201,1842,8905
9,2009-10,GSW,2009-10GSW,82,26,56,0.348,19730,3329,7094,2696,5407,633,1687,1631,2085,753,2397,3150,1839,761,340,1204,1886,8922
8,2010-11,GSW,2010-11GSW,82,36,46,0.463,19830,3251,7047,2566,5298,685,1749,1290,1695,955,2370,3325,1847,737,406,1198,1806,8477
7,2011-12,GSW,2011-12GSW,66,23,43,0.317,15915,2489,5443,1965,4092,524,1351,951,1235,640,1947,2587,1470,528,362,915,1410,6453
6,2012-13,GSW,2012-13GSW,82,47,35,0.598,19805,3130,6840,2472,5208,658,1632,1378,1744,885,2801,3686,1845,567,346,1236,1753,8296
5,2013-14,GSW,2013-14GSW,82,51,31,0.634,19830,3236,7005,2462,4968,774,2037,1303,1731,896,2819,3715,1912,642,407,1247,1784,8549
4,2014-15,GSW,2014-15GSW,82,67,15,0.817,19730,3410,7137,2527,4920,883,2217,1313,1709,853,2814,3667,2248,762,496,1185,1628,9016
3,2015-16,GSW,2015-16GSW,82,73,9,0.89,19880,3489,7159,2412,4567,1077,2592,1366,1790,816,2972,3788,2373,689,498,1245,1701,9421
2,2016-17,GSW,2016-17GSW,82,67,15,0.817,19780,3532,7140,2550,4578,982,2562,1457,1850,770,2873,3643,2491,785,555,1211,1585,9503
1,2017-18,GSW,2017-18GSW,8,5,3,0.195,1920,356,677,249,410,107,267,149,178,83,279,362,247,55,71,141,171,968
39,1979-80,HOU,1979-80HOU,82,41,41,0.512,19930,3599,7496,3495,7117,104,379,1782,2326,1394,2217,3611,2149,782,373,1565,1927,9084
38,1980-81,HOU,1980-81HOU,82,40,42,0.5,19805,3573,7335,3552,7217,21,118,1711,2223,1216,2347,3563,2099,705,390,1451,1901,8878
37,1981-82,HOU,1981-82HOU,82,46,36,0.573,19780,3504,7366,3454,7190,50,176,1622,2225,1403,2284,3687,1977,648,429,1321,1871,8680
36,1982-83,HOU,1982-83HOU,82,14,68,0.207,19730,3338,7446,3271,7175,67,271,1402,1934,1206,2260,3466,1931,646,422,1571,2131,8145
35,1983-84,HOU,1983-84HOU,82,29,53,0.366,19755,3729,7533,3699,7379,30,154,1583,2139,1200,2483,3683,2204,621,515,1562,2317,9071
34,1984-85,HOU,1984-85HOU,82,48,34,0.598,19830,3748,7440,3707,7254,41,186,1581,2261,1325,2395,3720,2239,683,597,1605,2033,9118
33,1985-86,HOU,1985-86HOU,82,51,31,0.634,19755,3759,7671,3674,7361,85,310,1776,2434,1316,2434,3750,2318,745,551,1374,1991,9379
32,1986-87,HOU,1986-87HOU,82,42,40,0.524,19780,3465,7262,3376,6938,89,324,1746,2355,1190,2481,3671,2227,654,555,1384,1973,8765
31,1987-88,HOU,1987-88HOU,82,46,36,0.573,19680,3465,7354,3396,7063,69,291,1936,2483,1239,2530,3769,1936,712,502,1367,1865,8935
30,1988-89,HOU,1988-89HOU,82,45,37,0.561,19855,3412,7196,3248,6673,164,523,1909,2527,1211,2554,3765,2016,789,501,1569,2026,8897
29,1989-90,HOU,1989-90HOU,82,41,41,0.512,19805,3483,7250,3330,6759,153,491,1633,2267,1217,2638,3855,2194,809,551,1513,1934,8752
28,1990-91,HOU,1990-91HOU,82,52,30,0.646,19855,3403,7287,3087,6298,316,989,1631,2200,1275,2508,3783,1906,796,409,1402,1874,8753
27,1991-92,HOU,1991-92HOU,82,42,40,0.524,19880,3273,6894,2944,5935,329,959,1491,2020,1074,2432,3506,2058,656,571,1378,1769,8366
26,1992-93,HOU,1992-93HOU,82,55,27,0.671,19780,3280,6744,2893,5671,387,1073,1584,2090,985,2532,3517,2115,682,543,1295,1699,8531
25,1993-94,HOU,1993-94HOU,82,58,24,0.714,19780,3197,6733,2768,5448,429,1285,1469,1978,926,2619,3545,2087,717,485,1338,1646,8292
24,1994-95,HOU,1994-95HOU,82,47,35,0.598,19730,3159,6579,2513,4822,646,1757,1527,2039,880,2440,3320,2060,721,514,1322,1714,8491
23,1995-96,HOU,1995-96HOU,82,48,34,0.598,19805,3078,6638,2441,4877,637,1761,1611,2106,919,2455,3374,1982,645,476,1245,1753,8404
22,1996-97,HOU,1996-97HOU,82,57,25,0.707,19855,3037,6484,2366,4645,671,1839,1503,1992,927,2565,3492,2013,685,347,1365,1610,8248
21,1997-98,HOU,1997-98HOU,82,41,41,0.512,19830,2946,6513,2373,4843,573,1670,1634,2120,987,2350,3337,1799,686,294,1298,1653,8099
20,1998-99,HOU,1998-99HOU,50,31,19,0.402,12075,1755,3798,1419,2884,336,914,865,1187,536,1540,2076,1058,386,260,812,960,4711
19,1999-00,HOU,1999-00HOU,82,34,48,0.439,19830,3001,6664,2420,5039,581,1625,1573,2145,1008,2586,3594,1774,613,438,1425,1663,8156
18,2000-01,HOU,2000-01HOU,82,45,37,0.571,19830,2943,6494,2439,5082,504,1412,1582,2086,919,2524,3443,1613,587,358,1204,1657,7972
17,2001-02,HOU,2001-02HOU,82,28,54,0.366,19980,2837,6629,2341,5149,496,1480,1402,1893,1025,2411,3436,1482,537,445,1156,1476,7572
16,2002-03,HOU,2002-03HOU,82,43,39,0.537,19930,2840,6461,2401,5194,439,1267,1569,2044,1024,2564,3588,1506,594,493,1276,1602,7688
15,2003-04,HOU,2003-04HOU,82,45,37,0.571,19930,2738,6195,2223,4789,515,1406,1371,1774,847,2647,3494,1579,560,443,1373,1762,7362
14,2004-05,HOU,2004-05HOU,82,51,31,0.634,19855,2846,6419,2293,4898,553,1521,1551,1986,874,2601,3475,1733,563,378,1135,1807,7796
13,2005-06,HOU,2005-06HOU,82,34,48,0.439,19830,2708,6252,2239,4838,469,1414,1502,1980,849,2565,3414,1580,588,320,1193,1863,7387
12,2006-07,HOU,2006-07HOU,82,52,30,0.646,19855,2906,6528,2201,4635,705,1893,1436,1906,880,2673,3553,1704,583,337,1162,1710,7953
11,2007-08,HOU,2007-08HOU,82,55,27,0.683,19730,3003,6698,2420,4991,583,1707,1342,1848,1002,2659,3661,1757,598,420,1125,1609,7931
10,2008-09,HOU,2008-09HOU,82,53,29,0.659,19805,2959,6526,2338,4870,621,1656,1531,1903,862,2662,3524,1662,548,355,1158,1553,8070
9,2009-10,HOU,2009-10HOU,82,42,40,0.537,19905,3094,6923,2448,5085,646,1838,1561,2022,971,2471,3442,1790,583,318,1188,1712,8395
8,2010-11,HOU,2010-11HOU,82,43,39,0.545,19880,3170,6975,2493,5132,677,1843,1668,2083,962,2549,3511,1955,581,371,1110,1641,8685
7,2011-12,HOU,2011-12HOU,66,34,32,0.439,16065,2489,5543,2011,4213,478,1330,1018,1301,769,2014,2783,1404,496,319,955,1347,6474
6,2012-13,HOU,2012-13HOU,82,45,37,0.573,19780,3124,6782,2257,4413,867,2369,1573,2087,909,2652,3561,1902,679,359,1348,1662,8688
5,2013-14,HOU,2013-14HOU,82,54,28,0.671,19830,3118,6603,2339,4424,779,2179,1814,2549,920,2797,3717,1755,621,461,1323,1676,8829
4,2014-15,HOU,2014-15HOU,82,56,26,0.695,19805,3032,6832,2099,4152,933,2680,1525,2133,958,2624,3582,1820,777,407,1366,1803,8522
3,2015-16,HOU,2015-16HOU,82,41,41,0.515,19830,3094,6847,2216,4314,878,2533,1671,2407,930,2601,3531,1821,821,430,1307,1790,8737
2,2016-17,HOU,2016-17HOU,82,55,27,0.683,19780,3305,7152,2124,3846,1181,3306,1667,2177,892,2746,3638,2070,670,352,1240,1634,9458
1,2017-18,HOU,2017-18HOU,8,5,3,0.2,1920,287,658,179,306,108,352,152,189,71,277,348,167,64,38,130,171,834
39,1979-80,IND,1979-80IND,82,37,45,0.476,19855,3639,7689,3551,7375,88,314,1753,2333,1398,2326,3724,2148,900,530,1517,1973,9119
38,1980-81,IND,1980-81IND,82,44,38,0.549,19730,3491,7245,3461,7076,30,169,1815,2540,1325,2267,3592,2091,833,484,1491,2006,8827
37,1981-82,IND,1981-82IND,82,35,47,0.44,19830,3332,7164,3229,6848,103,316,1612,2176,1141,2372,3513,1897,753,494,1393,2041,8379
36,1982-83,IND,1982-83IND,82,20,62,0.268,19830,3707,7723,3657,7487,50,236,1447,1910,1299,2294,3593,2150,755,411,1535,2086,8911
35,1983-84,IND,1983-84IND,82,26,56,0.341,19780,3447,7130,3399,6923,48,207,1624,2119,1002,2398,3400,2169,834,398,1525,2061,8566
34,1984-85,IND,1984-85IND,82,22,60,0.293,19780,3489,7324,3459,7169,30,155,1871,2516,1198,2623,3821,1945,625,366,1622,2237,8879
33,1985-86,IND,1985-86IND,82,26,56,0.341,19755,3441,7150,3418,7007,23,143,1614,2183,1138,2613,3751,2159,659,381,1515,2135,8519
32,1986-87,IND,1986-87IND,82,41,41,0.512,19930,3454,7324,3360,7008,94,316,1696,2170,1132,2464,3596,2170,697,311,1276,2097,8698
31,1987-88,IND,1987-88IND,82,38,44,0.488,19705,3436,7154,3273,6669,163,485,1546,1982,1078,2457,3535,1977,619,345,1318,2038,8581
30,1988-89,IND,1988-89IND,82,28,54,0.366,19855,3385,6945,3183,6330,202,615,1795,2275,1065,2497,3562,2012,563,418,1547,2105,8767
29,1989-90,IND,1989-90IND,82,42,40,0.524,19880,3381,6807,3087,6037,294,770,1906,2335,940,2388,3328,2023,552,350,1342,1972,8962
28,1990-91,IND,1990-91IND,82,41,41,0.512,19805,3450,6994,3201,6245,249,749,2010,2479,1018,2376,3394,2181,658,357,1355,2088,9159
27,1991-92,IND,1991-92IND,82,40,42,0.5,19955,3498,7079,3165,6139,333,940,1868,2364,1083,2564,3647,2398,705,393,1402,2137,9197
26,1992-93,IND,1992-93IND,82,41,41,0.512,19755,3371,7022,3114,6233,257,789,1837,2399,1220,2455,3675,2144,615,403,1256,2045,8836
25,1993-94,IND,1993-94IND,82,47,35,0.585,19755,3167,6516,2983,6016,184,500,1762,2387,1130,2409,3539,2055,706,457,1440,1974,8280
24,1994-95,IND,1994-95IND,82,52,30,0.646,19780,2983,6248,2609,5263,374,985,1796,2390,1051,2290,3341,1877,703,363,1340,1939,8136
23,1995-96,IND,1995-96IND,82,52,30,0.646,19755,2979,6205,2616,5232,363,973,1823,2416,1010,2262,3272,1917,579,323,1335,2031,8144
22,1996-97,IND,1996-97IND,82,39,43,0.5,19930,2851,6254,2421,5124,430,1130,1687,2336,1029,2390,3419,1750,585,394,1338,1977,7819
21,1997-98,IND,1997-98IND,82,58,24,0.712,19830,2921,6223,2520,5194,401,1029,1631,2136,874,2348,3222,1889,645,368,1168,1859,7874
20,1998-99,IND,1998-99IND,50,33,17,0.415,12100,1731,3866,1437,3067,294,799,977,1228,574,1452,2026,1005,316,223,649,1082,4733
19,1999-00,IND,1999-00IND,82,56,26,0.695,19730,3047,6640,2464,5153,583,1487,1629,2008,842,2612,3454,1857,559,422,1159,1786,8306
18,2000-01,IND,2000-01IND,82,41,41,0.512,19980,2828,6431,2432,5272,396,1159,1539,2009,921,2595,3516,1763,563,487,1244,1926,7591
17,2001-02,IND,2001-02IND,82,42,40,0.524,19905,2935,6580,2530,5385,405,1195,1663,2155,930,2568,3498,1884,658,436,1249,1876,7938
16,2002-03,IND,2002-03IND,82,48,34,0.598,19905,2911,6608,2532,5489,379,1119,1739,2271,1004,2622,3626,1910,696,443,1210,1811,7940
15,2003-04,IND,2003-04IND,82,61,21,0.744,19805,2753,6322,2304,5041,449,1281,1538,2014,965,2452,3417,1774,726,411,1182,1709,7493
14,2004-05,IND,2004-05IND,82,44,38,0.549,19905,2668,6169,2126,4594,542,1575,1748,2206,868,2418,3286,1489,615,357,1173,1890,7626
13,2005-06,IND,2005-06IND,82,41,41,0.512,19730,2786,6274,2250,4738,536,1536,1591,2158,898,2559,3457,1631,598,409,1254,1821,7699
12,2006-07,IND,2006-07IND,82,35,47,0.451,19780,2872,6561,2391,5172,481,1389,1615,2125,990,2441,3431,1680,599,447,1335,1912,7840
11,2007-08,IND,2007-08IND,82,36,46,0.463,19755,3102,6993,2347,4972,755,2021,1568,2042,904,2633,3537,1864,623,412,1236,1921,8527
10,2008-09,IND,2008-09IND,82,36,46,0.463,19830,3220,7080,2568,5355,652,1725,1525,1890,924,2661,3585,1775,573,434,1189,1895,8617
9,2009-10,IND,2009-10IND,82,32,50,0.415,19705,3020,6823,2361,4927,659,1896,1564,2019,785,2618,3403,1730,585,439,1232,1848,8263
8,2010-11,IND,2010-11IND,82,37,45,0.476,19780,3003,6787,2418,5134,585,1653,1592,2035,914,2657,3571,1611,584,456,1262,1782,8183
7,2011-12,IND,2011-12IND,66,42,24,0.524,15990,2354,5375,1962,4311,392,1064,1349,1724,826,2070,2896,1228,523,357,925,1430,6449
6,2012-13,IND,2012-13IND,81,49,32,0.61,19590,2845,6525,2290,4926,555,1599,1429,1915,1043,2671,3714,1645,580,513,1227,1623,7674
5,2013-14,IND,2013-14IND,82,56,26,0.695,19780,2949,6573,2399,5031,550,1542,1485,1907,834,2831,3665,1651,550,446,1237,1675,7933
4,2014-15,IND,2014-15IND,82,38,44,0.488,19855,2998,6824,2386,5084,612,1740,1373,1817,856,2822,3678,1757,505,375,1147,1742,7981
3,2015-16,IND,2015-16IND,82,45,37,0.573,19880,3142,6985,2479,5096,663,1889,1430,1872,847,2779,3626,1741,742,391,1219,1641,8377
2,2016-17,IND,2016-17IND,82,42,40,0.537,19855,3221,6931,2512,5046,709,1885,1467,1811,742,2702,3444,1844,669,409,1130,1597,8618
1,2017-18,IND,2017-18IND,6,3,3,0.146,1440,251,520,201,376,50,144,115,152,61,197,258,127,52,24,93,124,667
39,1979-80,KCK,1979-80KCK,82,47,35,0.573,19805,3582,7489,3557,7375,25,114,1671,2250,1187,2429,3616,2123,863,356,1439,2135,8860
38,1980-81,KCK,1980-81KCK,82,40,42,0.5,19830,3572,7151,3523,6983,49,168,1576,2206,1037,2450,3487,2271,719,385,1448,2092,8769
37,1981-82,KCK,1981-82KCK,82,30,52,0.379,19880,3604,7284,3578,7154,26,130,1551,2158,1086,2276,3362,2056,743,402,1507,2359,8785
36,1982-83,KCK,1982-83KCK,82,45,37,0.561,19780,3719,7485,3668,7270,51,215,1839,2530,1256,2407,3663,2155,765,409,1691,2432,9328
35,1983-84,KCK,1983-84KCK,82,38,44,0.488,19755,3516,7230,3464,7041,52,189,1939,2495,1144,2273,3417,2229,715,383,1504,2200,9023
34,1984-85,KCK,1984-85KCK,82,31,51,0.402,19755,3664,7275,3601,7037,63,238,2022,2595,1167,2327,3494,2342,661,300,1593,2169,9413
34,1984-85,LAC,1984-85LAC,82,31,51,0.402,19730,3527,7119,3471,6931,56,188,1674,2208,1163,2434,3597,1934,534,497,1587,1840,8784
33,1985-86,LAC,1985-86LAC,82,32,50,0.415,19755,3388,7165,3324,6936,64,229,2067,2683,1159,2258,3417,1968,694,501,1506,1931,8907
32,1986-87,LAC,1986-87LAC,82,12,70,0.207,19780,3311,7332,3233,6984,78,348,1866,2515,1231,2137,3368,1971,751,432,1493,2004,8566
31,1987-88,LAC,1987-88LAC,82,17,65,0.232,19805,3190,7194,3111,6877,79,317,1644,2305,1191,2350,3541,1885,721,520,1534,1908,8103
30,1988-89,LAC,1988-89LAC,82,21,61,0.28,19855,3526,7428,3472,7194,54,234,1606,2220,1156,2384,3540,2208,815,530,1666,1937,8712
29,1989-90,LAC,1989-90LAC,82,30,52,0.39,19805,3319,6853,3263,6623,56,230,1815,2458,1056,2362,3418,1978,782,507,1547,1859,8509
28,1990-91,LAC,1990-91LAC,82,31,51,0.402,19805,3391,7315,3278,6881,113,434,1596,2273,1246,2500,3746,2119,725,507,1438,2043,8491
27,1991-92,LAC,1991-92LAC,82,45,37,0.561,19830,3347,7076,3202,6574,145,502,1601,2223,1132,2393,3525,2053,824,498,1269,1873,8440
26,1992-93,LAC,1992-93LAC,82,41,41,0.512,19805,3544,7329,3411,6838,133,491,1562,2177,1183,2360,3543,2242,847,491,1338,1920,8783
25,1993-94,LAC,1993-94LAC,82,27,55,0.354,19780,3343,7163,3091,6332,252,831,1509,2128,1120,2410,3530,2169,807,421,1474,1769,8447
24,1994-95,LAC,1994-95LAC,82,17,65,0.244,19880,3060,6888,2729,5837,331,1051,1476,2079,1064,2076,3140,1805,787,435,1334,2152,7927
23,1995-96,LAC,1995-96LAC,82,29,53,0.378,19730,3126,6618,2617,5244,509,1374,1392,1984,979,2190,3169,1672,703,411,1355,2008,8153
22,1996-97,LAC,1996-97LAC,82,36,46,0.463,19930,2989,6696,2515,5357,474,1339,1517,2074,1092,2242,3334,1662,733,441,1311,1964,7969
21,1997-98,LAC,1997-98LAC,82,17,65,0.244,19780,2930,6690,2405,5222,525,1468,1480,2047,1040,2276,3316,1533,625,456,1323,1827,7865
20,1998-99,LAC,1998-99LAC,50,9,41,0.207,12125,1711,4007,1497,3339,214,668,883,1225,665,1293,1958,820,424,236,796,1223,4519
19,1999-00,LAC,1999-00LAC,82,15,67,0.232,19705,2877,6757,2448,5490,429,1267,1363,1826,955,2377,3332,1479,578,494,1325,1821,7546
18,2000-01,LAC,2000-01LAC,82,31,51,0.402,20030,2896,6467,2536,5404,360,1063,1429,2061,962,2559,3521,1585,490,513,1293,1775,7581
17,2001-02,LAC,2001-02LAC,82,39,43,0.5,19805,2970,6668,2562,5521,408,1147,1498,2026,1083,2474,3557,1714,510,540,1214,1624,7846
16,2002-03,LAC,2002-03LAC,82,27,55,0.354,19755,2835,6490,2445,5312,390,1178,1633,2177,1008,2462,3470,1605,574,461,1291,1784,7693
15,2003-04,LAC,2003-04LAC,82,28,54,0.366,19805,2817,6579,2488,5555,329,1024,1808,2302,1149,2416,3565,1653,594,376,1344,1816,7771
14,2004-05,LAC,2004-05LAC,82,37,45,0.476,20030,2924,6368,2693,5699,231,669,1770,2274,980,2455,3435,1901,599,422,1290,1819,7849
13,2005-06,LAC,2005-06LAC,82,47,35,0.585,19805,2993,6443,2703,5600,290,843,1694,2142,828,2704,3532,1708,534,503,1185,1872,7970
12,2006-07,LAC,2006-07LAC,82,40,42,0.5,19730,2880,6318,2566,5415,314,903,1769,2245,888,2484,3372,1762,596,472,1239,1858,7843
11,2007-08,LAC,2007-08LAC,82,23,59,0.305,19805,2820,6445,2470,5366,350,1079,1702,2178,800,2491,3291,1732,557,398,1180,1745,7692
10,2008-09,LAC,2008-09LAC,82,19,63,0.268,19880,2955,6696,2420,5183,535,1513,1354,1839,890,2377,3267,1723,572,482,1221,1650,7799
9,2009-10,LAC,2009-10LAC,82,29,53,0.378,19705,3002,6601,2519,5144,483,1457,1362,1867,927,2502,3429,1810,532,466,1285,1581,7849
8,2010-11,LAC,2010-11LAC,82,32,50,0.415,19855,3015,6594,2502,5075,513,1519,1546,2187,955,2501,3456,1813,585,402,1343,1733,8089
7,2011-12,LAC,2011-12LAC,66,40,26,0.5,15965,2439,5366,1925,3925,514,1441,1046,1538,800,1943,2743,1385,556,315,879,1399,6438
6,2012-13,LAC,2012-13LAC,82,56,26,0.695,19730,3160,6608,2533,4856,627,1752,1342,1888,938,2475,3413,1958,784,461,1197,1716,8289
5,2013-14,LAC,2013-14LAC,82,57,25,0.707,19755,3208,6761,2515,4795,693,1966,1741,2384,858,2668,3526,2016,703,397,1136,1767,8850
4,2014-15,LAC,2014-15LAC,82,56,26,0.695,19730,3228,6830,2401,4628,827,2202,1468,2067,784,2711,3495,2031,640,409,1012,1749,8751
3,2015-16,LAC,2015-16LAC,82,53,29,0.659,19830,3141,6759,2344,4569,797,2190,1490,2152,721,2727,3448,1873,709,460,1063,1746,8569
2,2016-17,LAC,2016-17LAC,82,51,31,0.634,19755,3242,6820,2401,4575,841,2245,1586,2128,738,2790,3528,1848,612,347,1062,1626,8911
1,2017-18,LAC,2017-18LAC,6,4,2,0.183,1440,232,525,164,346,68,179,112,152,76,211,287,121,50,23,86,125,644
39,1979-80,LAL,1979-80LAL,82,60,22,0.732,19880,3898,7368,3878,7268,20,100,1622,2092,1085,2653,3738,2413,774,546,1639,1784,9438
38,1980-81,LAL,1980-81LAL,82,54,28,0.659,19805,3780,7382,3763,7288,17,94,1540,2113,1165,2491,3656,2363,808,551,1557,1955,9117
37,1981-82,LAL,1981-82LAL,82,57,25,0.695,19855,3919,7585,3906,7491,13,94,1549,2161,1258,2505,3763,2356,848,517,1468,1999,9400
36,1982-83,LAL,1982-83LAL,82,58,24,0.707,19730,3964,7512,3954,7416,10,96,1495,2031,1235,2433,3668,2519,844,479,1584,1931,9433
35,1983-84,LAL,1983-84LAL,82,54,28,0.659,19780,3854,7250,3796,7024,58,226,1712,2272,1095,2499,3594,2455,726,478,1578,2054,9478
34,1984-85,LAL,1984-85LAL,82,62,20,0.756,19755,3952,7254,3862,6959,90,295,1702,2232,1063,2550,3613,2575,695,481,1537,1931,9696
33,1985-86,LAL,1985-86LAL,82,62,20,0.756,19830,3834,7343,3696,6934,138,409,1812,2329,1101,2555,3656,2433,693,419,1467,2031,9618
32,1986-87,LAL,1986-87LAL,82,65,17,0.793,19730,3740,7245,3576,6798,164,447,2012,2550,1127,2515,3642,2428,728,482,1358,1853,9656
31,1987-88,LAL,1987-88LAL,82,62,20,0.756,19805,3576,7078,3434,6600,142,478,1956,2480,1073,2491,3564,2347,672,404,1318,1715,9250
30,1988-89,LAL,1988-89LAL,82,57,25,0.695,19805,3584,7143,3357,6476,227,667,2011,2508,1094,2612,3706,2282,724,421,1344,1672,9406
29,1989-90,LAL,1989-90LAL,82,63,19,0.768,19855,3434,7010,3125,6169,309,841,1902,2417,1097,2460,3557,2232,655,445,1226,1737,9079
28,1990-91,LAL,1990-91LAL,82,58,24,0.707,19830,3343,6911,3117,6167,226,744,1805,2261,1078,2440,3518,2091,642,384,1203,1524,8717
27,1991-92,LAL,1991-92LAL,82,43,39,0.537,19830,3183,6977,3064,6532,119,445,1744,2278,1156,2196,3352,1803,756,400,1089,1543,8229
26,1992-93,LAL,1992-93LAL,82,39,43,0.5,19830,3309,6994,3122,6368,187,626,1741,2304,1103,2288,3391,2013,782,431,1266,1778,8546
25,1993-94,LAL,1993-94LAL,82,33,49,0.42,19755,3291,7316,3050,6513,241,803,1410,1967,1260,2204,3464,1983,751,461,1197,1877,8233
24,1994-95,LAL,1994-95LAL,82,48,34,0.598,19905,3284,7088,2759,5596,525,1492,1523,2072,1126,2316,3442,2078,750,563,1243,1933,8616
23,1995-96,LAL,1995-96LAL,82,53,29,0.659,19680,3216,6706,2739,5347,477,1359,1529,2049,995,2303,3298,2080,722,516,1163,1702,8438
22,1996-97,LAL,1996-97LAL,82,56,26,0.695,19930,3018,6642,2467,5142,551,1500,1613,2330,1092,2414,3506,1845,740,575,1222,1818,8200
21,1997-98,LAL,1997-98LAL,82,61,21,0.744,19830,3146,6536,2649,5121,497,1415,1863,2743,1079,2471,3550,2009,734,556,1256,1859,8652
20,1998-99,LAL,1998-99LAL,50,31,19,0.402,12050,1841,3935,1600,3250,241,685,1027,1503,619,1482,2101,1095,389,287,754,1231,4950
19,1999-00,LAL,1999-00LAL,82,67,15,0.817,19805,3137,6836,2793,5789,344,1047,1649,2368,1117,2738,3855,1921,613,534,1143,1841,8267
18,2000-01,LAL,2000-01LAL,82,56,26,0.695,19905,3109,6685,2670,5410,439,1275,1594,2333,1085,2583,3668,1888,564,490,1184,1872,8251
17,2001-02,LAL,2001-02LAL,82,58,24,0.72,19780,3150,6840,2640,5401,510,1439,1494,2138,1022,2607,3629,1882,625,478,1040,1823,8304
16,2002-03,LAL,2002-03LAL,82,50,32,0.622,19930,3091,6856,2605,5489,486,1367,1562,2129,1078,2554,3632,1909,639,470,1192,1874,8230
15,2003-04,LAL,2003-04LAL,82,56,26,0.683,19855,3028,6676,2663,5561,365,1115,1631,2352,1001,2535,3536,1948,682,379,1132,1732,8052
14,2004-05,LAL,2004-05LAL,82,34,48,0.439,19780,2895,6629,2251,4816,644,1813,1661,2137,1028,2511,3539,1672,508,344,1176,1794,8095
13,2005-06,LAL,2005-06LAL,82,45,37,0.573,19855,2992,6607,2440,5024,552,1583,1618,2172,970,2488,3458,1734,628,350,1143,1894,8154
12,2006-07,LAL,2006-07LAL,82,42,40,0.537,20030,3103,6664,2495,4940,608,1724,1660,2221,886,2495,3381,1850,600,421,1273,1889,8474
11,2007-08,LAL,2007-08LAL,82,57,25,0.707,19780,3248,6818,2586,5067,662,1751,1746,2270,898,2722,3620,2003,654,438,1156,1691,8904
10,2008-09,LAL,2008-09LAL,82,65,17,0.793,19780,3307,6981,2760,5465,547,1516,1607,2087,1015,2587,3602,1908,718,420,1103,1698,8768
9,2009-10,LAL,2009-10LAL,82,57,25,0.707,19830,3144,6875,2612,5313,532,1562,1519,1985,973,2662,3635,1730,612,400,1096,1592,8339
8,2010-11,LAL,2010-11LAL,82,57,25,0.7,19830,3128,6757,2604,5270,524,1487,1541,1979,989,2616,3605,1801,602,422,1073,1555,8321
7,2011-12,LAL,2011-12LAL,66,41,25,0.512,16065,2429,5319,2067,4207,362,1112,1202,1589,799,2251,3050,1485,390,351,997,1109,6422
6,2012-13,LAL,2012-13LAL,82,45,37,0.573,19755,3041,6640,2326,4625,715,2015,1584,2289,942,2732,3674,1818,576,429,1232,1467,8381
5,2013-14,LAL,2013-14LAL,82,27,55,0.354,19705,3139,6980,2365,4948,774,2032,1390,1835,745,2620,3365,2006,611,446,1239,1627,8442
4,2014-15,LAL,2014-15LAL,82,21,61,0.293,19930,3054,7020,2522,5474,532,1546,1433,1935,952,2647,3599,1715,578,366,1086,1741,8073
3,2015-16,LAL,2015-16LAL,82,17,65,0.244,19730,2880,6956,2241,4940,639,2016,1583,2028,878,2645,3523,1478,593,337,1124,1662,7982
2,2016-17,LAL,2016-17LAL,82,26,56,0.354,19705,3224,7164,2494,5054,730,2110,1397,1853,933,2636,3569,1716,674,320,1243,1698,8575
1,2017-18,LAL,2017-18LAL,6,2,4,0.134,1465,237,527,197,383,40,144,97,136,55,218,273,134,51,31,115,138,611
17,2001-02,MEM,2001-02MEM,82,23,59,0.305,19780,2851,6535,2515,5439,336,1096,1334,1883,984,2413,3397,1785,646,488,1344,1571,7372
16,2002-03,MEM,2002-03MEM,82,28,54,0.366,19930,3049,6743,2582,5464,467,1279,1430,1936,943,2466,3409,1892,651,500,1262,1678,7995
15,2003-04,MEM,2003-04MEM,82,50,32,0.622,19880,2963,6657,2516,5343,447,1314,1557,2143,1047,2381,3428,1915,795,565,1226,1903,7930
14,2004-05,MEM,2004-05MEM,82,45,37,0.571,19705,2802,6271,2271,4785,531,1486,1526,2024,887,2307,3194,1716,699,476,1197,1910,7661
13,2005-06,MEM,2005-06MEM,82,49,33,0.61,19855,2746,6125,2156,4547,590,1578,1476,2077,834,2379,3213,1586,600,442,1134,1757,7558
12,2006-07,MEM,2006-07MEM,82,22,60,0.305,19980,2998,6448,2498,5086,500,1362,1835,2410,866,2375,3241,1680,564,407,1343,1827,8331
11,2007-08,MEM,2007-08MEM,82,22,60,0.305,19805,3060,6737,2440,4958,620,1779,1517,2097,848,2567,3415,1574,503,386,1251,1592,8257
10,2008-09,MEM,2008-09MEM,82,24,58,0.317,19805,2865,6311,2467,5205,398,1106,1570,2077,847,2337,3184,1423,615,385,1252,1777,7698
9,2009-10,MEM,2009-10MEM,82,40,42,0.5,19905,3223,6875,2879,5855,344,1020,1614,2202,1070,2496,3566,1543,645,399,1248,1655,8404
8,2010-11,MEM,2010-11MEM,82,46,36,0.573,19880,3200,6801,2891,5875,309,926,1486,1981,970,2391,3361,1691,771,441,1145,1705,8195
7,2011-12,MEM,2011-12MEM,66,41,25,0.512,15940,2425,5422,2148,4573,277,849,1142,1504,831,1944,2775,1290,631,345,955,1316,6269
6,2012-13,MEM,2012-13MEM,82,56,26,0.683,19805,2964,6679,2582,5572,382,1107,1349,1746,1059,2445,3504,1715,703,436,1144,1660,7659
5,2013-14,MEM,2013-14MEM,82,50,32,0.622,19805,3122,6723,2717,5576,405,1147,1235,1666,950,2526,3476,1792,631,375,1124,1568,7884
4,2014-15,MEM,2014-15MEM,82,55,27,0.671,19905,3097,6763,2674,5517,423,1246,1445,1869,856,2634,3490,1777,700,347,1094,1567,8062
3,2015-16,MEM,2015-16MEM,82,42,40,0.537,19830,3019,6859,2515,5338,504,1521,1584,2024,916,2497,3413,1697,724,350,1090,1783,8126
2,2016-17,MEM,2016-17MEM,82,43,39,0.549,19905,2984,6854,2217,4685,767,2169,1504,1918,886,2621,3507,1744,653,344,1059,1840,8239
1,2017-18,MEM,2017-18MEM,7,5,2,0.195,1680,239,560,170,352,69,208,157,201,56,239,295,130,53,36,90,162,704
30,1988-89,MIA,1988-89MIA,82,15,67,0.22,19855,3221,7116,3124,6818,97,298,1477,2103,1309,2211,3520,1958,744,408,1728,2124,8016
29,1989-90,MIA,1989-90MIA,82,18,64,0.256,19730,3383,7345,3295,7045,88,300,1393,2028,1242,2313,3555,1957,736,388,1557,2123,8247
28,1990-91,MIA,1990-91MIA,82,24,58,0.317,19780,3280,7139,3140,6675,140,464,1649,2307,1232,2302,3534,1904,756,387,1551,2080,8349
27,1991-92,MIA,1991-92MIA,82,38,44,0.488,19830,3256,7061,2999,6310,257,751,1839,2329,1187,2366,3553,1749,670,373,1377,1819,8608
26,1992-93,MIA,1992-93MIA,82,36,46,0.463,20005,3127,6850,2794,5910,333,940,1908,2476,1134,2384,3518,1688,609,350,1287,2011,8495
25,1993-94,MIA,1993-94MIA,82,42,40,0.524,19805,3197,6896,2860,5899,337,997,1744,2223,1235,2407,3642,1856,643,374,1315,2024,8475
24,1994-95,MIA,1994-95MIA,82,32,50,0.415,19805,3144,6738,2708,5556,436,1182,1569,2133,1092,2272,3364,1779,662,298,1291,2000,8293
23,1995-96,MIA,1995-96MIA,82,42,40,0.537,19780,2902,6348,2350,4890,552,1458,1553,2187,999,2495,3494,1752,574,439,1394,2158,7909
22,1996-97,MIA,1996-97MIA,82,61,21,0.744,19805,2822,6235,2144,4370,678,1865,1454,2022,957,2402,3359,1735,650,439,1306,1919,7776
21,1997-98,MIA,1997-98MIA,82,55,27,0.683,19755,2850,6327,2302,4783,548,1544,1539,2082,1028,2419,3447,1758,665,429,1226,1982,7787
20,1998-99,MIA,1998-99MIA,50,33,17,0.424,12025,1616,3565,1327,2761,289,804,928,1262,503,1512,2015,1019,327,304,744,1035,4449
19,1999-00,MIA,1999-00MIA,82,52,30,0.646,19830,2974,6462,2528,5260,446,1202,1345,1827,921,2619,3540,1931,582,524,1231,1947,7739
18,2000-01,MIA,2000-01MIA,82,50,32,0.622,19880,2694,6258,2216,4874,478,1384,1423,1874,813,2435,3248,1630,633,304,1122,1726,7289
17,2001-02,MIA,2001-02MIA,82,36,46,0.463,19930,2801,6382,2489,5483,312,899,1236,1708,902,2544,3446,1664,547,448,1217,1846,7150
16,2002-03,MIA,2002-03MIA,82,25,57,0.333,19830,2688,6517,2340,5417,348,1100,1292,1689,948,2464,3412,1501,592,324,1167,1856,7016
15,2003-04,MIA,2003-04MIA,82,42,40,0.537,19755,2729,6417,2244,5060,485,1357,1459,1915,940,2459,3399,1565,590,313,1137,1812,7402
14,2004-05,MIA,2004-05MIA,82,59,23,0.72,19980,3097,6368,2622,5108,475,1260,1658,2466,887,2639,3526,1790,528,474,1127,1814,8327
13,2005-06,MIA,2005-06MIA,82,52,30,0.646,19755,3039,6355,2542,4914,497,1441,1616,2310,858,2675,3533,1692,522,442,1186,1871,8191
12,2006-07,MIA,2006-07MIA,82,44,38,0.549,19855,2919,6288,2391,4749,528,1539,1393,2019,817,2526,3343,1681,566,442,1201,1749,7759
11,2007-08,MIA,2007-08MIA,82,15,67,0.232,19830,2808,6336,2317,4963,491,1373,1384,1903,743,2342,3085,1644,589,355,1202,1670,7491
10,2008-09,MIA,2008-09MIA,82,43,39,0.545,19955,3034,6646,2452,5015,582,1631,1411,1871,828,2411,3239,1671,651,451,1026,1696,8061
9,2009-10,MIA,2009-10MIA,82,47,35,0.585,19880,2984,6518,2490,5092,494,1426,1452,1931,875,2553,3428,1548,605,457,1079,1710,7914
8,2010-11,MIA,2010-11MIA,82,58,24,0.72,19780,3031,6301,2484,4822,547,1479,1760,2288,790,2666,3456,1639,544,430,1142,1674,8369
7,2011-12,MIA,2011-12MIA,66,46,20,0.573,16040,2446,5212,2076,4182,370,1030,1238,1598,686,2060,2746,1317,585,355,1002,1282,6500
6,2012-13,MIA,2012-13MIA,82,66,16,0.805,19880,3148,6348,2431,4539,717,1809,1423,1887,676,2490,3166,1890,710,441,1143,1533,8436
5,2013-14,MIA,2013-14MIA,82,54,28,0.671,19880,3142,6272,2477,4443,665,1829,1431,1884,627,2397,3024,1847,732,367,1212,1596,8380
4,2014-15,MIA,2014-15MIA,82,37,45,0.476,19730,2885,6330,2329,4671,556,1659,1438,1940,747,2461,3208,1626,642,372,1214,1636,7764
3,2015-16,MIA,2015-16MIA,82,48,34,0.598,19830,3150,6697,2652,5217,498,1480,1406,1889,807,2811,3618,1709,553,531,1155,1502,8204
2,2016-17,MIA,2016-17MIA,82,41,41,0.512,19780,3202,7037,2394,4824,808,2213,1248,1768,872,2705,3577,1742,588,469,1102,1680,8460
1,2017-18,MIA,2017-18MIA,6,2,4,0.146,1465,248,526,189,341,59,185,82,108,52,200,252,125,44,37,98,134,637
39,1979-80,MIL,1979-80MIL,82,49,33,0.61,19805,3685,7553,3635,7398,50,155,1605,2102,1245,2396,3641,2277,778,510,1496,1937,9025
38,1980-81,MIL,1980-81MIL,82,60,22,0.732,19755,3722,7472,3692,7341,30,131,1802,2340,1261,2408,3669,2319,862,530,1581,2198,9276
37,1981-82,MIL,1981-82MIL,82,55,27,0.671,19805,3544,7015,3495,6851,49,164,1753,2329,1167,2415,3582,2233,763,455,1589,2281,8890
36,1982-83,MIL,1982-83MIL,82,51,31,0.634,19830,3486,7133,3449,6964,37,169,1731,2299,1095,2477,3572,2116,662,532,1447,2131,8740
35,1983-84,MIL,1983-84MIL,82,50,32,0.61,19905,3432,6970,3373,6738,59,232,1743,2354,1135,2385,3520,2113,642,489,1415,2167,8666
34,1984-85,MIL,1984-85MIL,82,59,23,0.72,19805,3564,7256,3475,6962,89,294,1873,2473,1256,2353,3609,2164,689,486,1382,2239,9090
33,1985-86,MIL,1985-86MIL,82,57,25,0.695,19805,3601,7310,3476,6928,125,382,2063,2701,1189,2420,3609,2158,805,460,1369,2210,9390
32,1986-87,MIL,1986-87MIL,82,50,32,0.61,19780,3457,7282,3272,6710,185,572,1953,2549,1119,2322,3441,2044,845,393,1260,2180,9052
31,1987-88,MIL,1987-88MIL,82,42,40,0.524,19780,3366,7079,3233,6669,133,410,1832,2364,1117,2335,3452,2194,671,380,1275,1989,8697
30,1988-89,MIL,1988-89MIL,82,49,33,0.61,19755,3399,7167,3220,6600,179,567,1955,2382,1133,2272,3405,2071,821,323,1305,1953,8932
29,1989-90,MIL,1989-90MIL,82,44,38,0.549,19830,3380,7146,3171,6476,209,670,1722,2273,1108,2246,3354,2046,826,326,1315,2086,8691
28,1990-91,MIL,1990-91MIL,82,48,34,0.598,19855,3337,6948,3080,6195,257,753,1796,2241,1079,2162,3241,2075,894,330,1321,2033,8727
27,1991-92,MIL,1991-92MIL,82,31,51,0.402,19880,3321,7216,2950,6211,371,1005,1596,2104,1297,2172,3469,2018,863,317,1350,1904,8609
26,1992-93,MIL,1992-93MIL,82,28,54,0.366,19730,3268,6924,2956,5988,312,936,1544,2081,1050,2113,3163,2084,863,393,1363,1978,8392
25,1993-94,MIL,1993-94MIL,82,20,62,0.268,19705,3044,6807,2713,5788,331,1019,1530,2181,1126,2154,3280,1946,800,407,1343,1821,7949
24,1994-95,MIL,1994-95MIL,82,34,48,0.439,19855,3022,6586,2528,5237,494,1349,1608,2259,1063,2187,3250,1737,674,359,1393,1858,8146
23,1995-96,MIL,1995-96MIL,82,25,57,0.333,19730,3034,6490,2677,5434,357,1056,1412,1914,973,2164,3137,1755,582,307,1295,1943,7837
22,1996-97,MIL,1996-97MIL,82,33,49,0.427,19730,2967,6303,2643,5383,324,920,1560,2104,955,2263,3218,1610,632,348,1285,1892,7818
21,1997-98,MIL,1997-98MIL,82,36,46,0.46,19930,2918,6399,2669,5696,249,703,1663,2167,1035,2236,3271,1649,733,357,1383,1915,7748
20,1998-99,MIL,1998-99MIL,50,28,22,0.366,12050,1753,3818,1522,3199,231,619,847,1155,570,1369,1939,1030,442,202,719,1142,4584
19,1999-00,MIL,1999-00MIL,82,42,40,0.524,19855,3174,6827,2780,5758,394,1069,1558,1982,1016,2373,3389,1852,671,381,1230,2020,8300
18,2000-01,MIL,2000-01MIL,82,52,30,0.646,19780,3112,6798,2550,5317,562,1481,1474,1874,975,2500,3475,1844,672,386,1123,1928,8260
17,2001-02,MIL,2001-02MIL,82,41,41,0.512,19905,3041,6577,2448,4994,593,1583,1321,1767,841,2557,3398,1847,596,388,1157,1788,7996
16,2002-03,MIL,2002-03MIL,82,42,40,0.537,19905,3045,6670,2460,5144,585,1526,1483,1911,876,2367,3243,1823,622,344,1044,1820,8158
15,2003-04,MIL,2003-04MIL,82,41,41,0.512,19780,2970,6650,2569,5505,401,1145,1698,2192,960,2502,3462,1872,554,383,1110,1668,8039
14,2004-05,MIL,2004-05MIL,82,30,52,0.39,19780,2964,6580,2639,5655,325,925,1720,2229,985,2405,3390,1720,529,289,1132,1797,7973
13,2005-06,MIL,2005-06MIL,82,40,42,0.5,19855,2976,6566,2469,5231,507,1335,1561,2115,929,2448,3377,1769,597,270,1197,1902,8020
12,2006-07,MIL,2006-07MIL,82,28,54,0.366,19855,3121,6714,2597,5242,524,1472,1406,1919,941,2272,3213,1771,587,224,1240,1821,8172
11,2007-08,MIL,2007-08MIL,82,26,56,0.341,19855,3026,6745,2574,5432,452,1313,1452,1980,1055,2363,3418,1760,544,361,1210,1748,7956
10,2008-09,MIL,2008-09MIL,82,34,48,0.439,19780,3009,6755,2498,5347,511,1408,1613,2067,973,2367,3340,1802,609,308,1154,1986,8142
9,2009-10,MIL,2009-10MIL,82,46,36,0.573,19980,3050,6998,2405,5185,645,1813,1264,1675,965,2560,3525,1740,580,385,1085,1823,8009
8,2010-11,MIL,2010-11MIL,82,35,47,0.451,19830,2814,6544,2331,5130,483,1414,1423,1881,862,2480,3342,1545,617,399,1103,1682,7534
7,2011-12,MIL,2011-12MIL,66,31,35,0.402,15865,2502,5652,2066,4387,436,1265,1095,1415,820,1983,2803,1550,548,335,929,1273,6535
6,2012-13,MIL,2012-13MIL,82,38,44,0.488,19830,3128,7197,2527,5527,601,1670,1251,1700,1068,2537,3605,1876,685,550,1156,1554,8108
5,2013-14,MIL,2013-14MIL,82,15,67,0.232,19880,2952,6737,2404,5184,548,1553,1377,1843,971,2399,3370,1760,541,403,1238,1713,7829
4,2014-15,MIL,2014-15MIL,82,41,41,0.512,19930,3083,6722,2538,5222,545,1500,1312,1734,876,2574,3450,1932,789,403,1373,1814,8023
3,2015-16,MIL,2015-16MIL,82,33,49,0.427,19830,3145,6740,2705,5463,440,1277,1392,1863,858,2559,3417,1895,672,475,1247,1695,8122
2,2016-17,MIL,2016-17MIL,82,42,40,0.537,19780,3182,6715,2462,4769,720,1946,1413,1839,723,2589,3312,1984,666,436,1145,1660,8497
1,2017-18,MIL,2017-18MIL,6,4,2,0.183,1440,237,481,179,330,58,151,95,123,33,198,231,140,46,23,89,136,627
29,1989-90,MIN,1989-90MIN,82,22,60,0.293,19855,3067,6876,2994,6582,73,294,1596,2137,1196,2053,3249,1844,789,344,1197,1901,7803
28,1990-91,MIN,1990-91MIN,82,29,53,0.378,19905,3265,7276,3157,6895,108,381,1531,2082,1275,2113,3388,1885,712,440,1062,1864,8169
27,1991-92,MIN,1991-92MIN,82,15,67,0.22,19805,3366,7342,3240,6948,126,394,1379,1857,1167,2168,3335,2025,619,526,1157,1866,8237
26,1992-93,MIN,1992-93MIN,82,19,63,0.256,19855,3043,6529,2877,5960,166,569,1794,2247,940,2204,3144,2001,649,455,1422,2028,8046
25,1993-94,MIN,1993-94MIN,82,20,62,0.268,19730,2985,6535,2802,5978,183,557,1777,2303,990,2343,3333,1967,600,440,1478,2016,7930
24,1994-95,MIN,1994-95MIN,82,21,61,0.293,19780,2792,6219,2474,5203,318,1016,1824,2355,883,2090,2973,1780,609,402,1400,2074,7726
23,1995-96,MIN,1995-96MIN,82,26,56,0.341,19780,2974,6481,2695,5624,279,857,1797,2314,985,2271,3256,1867,650,481,1426,1994,8024
22,1996-97,MIN,1996-97MIN,82,40,42,0.5,19780,2937,6436,2566,5343,371,1093,1637,2180,957,2302,3259,1874,618,557,1243,1818,7882
21,1997-98,MIN,1997-98MIN,82,45,37,0.561,19930,3157,6844,2854,5971,303,873,1673,2253,1063,2429,3492,2068,639,427,1138,1882,8290
20,1998-99,MIN,1998-99MIN,50,25,25,0.329,12025,1838,4327,1716,3917,122,410,849,1143,754,1392,2146,1218,426,272,641,1185,4647
19,1999-00,MIN,1999-00MIN,82,50,32,0.61,19905,3226,6910,2978,6194,248,716,1379,1769,1016,2471,3487,2205,622,444,1139,1913,8079
18,2000-01,MIN,2000-01MIN,82,47,35,0.585,19830,3148,6871,2826,5970,322,901,1364,1737,1002,2470,3472,2083,682,456,1136,1900,7982
17,2001-02,MIN,2001-02MIN,82,50,32,0.62,19805,3175,6887,2779,5840,396,1047,1399,1754,1059,2562,3621,1993,524,427,1097,1739,8145
16,2002-03,MIN,2002-03MIN,82,51,31,0.634,19805,3172,6809,2876,6005,296,804,1406,1826,959,2614,3573,2070,553,433,1124,1704,8046
15,2003-04,MIN,2003-04MIN,82,58,24,0.707,19755,3033,6571,2707,5674,326,897,1361,1743,875,2645,3520,1890,561,462,1043,1731,7753
14,2004-05,MIN,2004-05MIN,82,44,38,0.549,19755,3045,6629,2650,5484,395,1145,1449,1820,947,2580,3527,1918,460,447,1079,1774,7934
13,2005-06,MIN,2005-06MIN,82,33,49,0.427,19855,2888,6340,2578,5398,310,942,1436,1895,811,2422,3233,1716,559,471,1189,1889,7522
12,2006-07,MIN,2006-07MIN,82,32,50,0.415,20005,2997,6503,2613,5414,384,1089,1499,1892,819,2474,3293,1848,532,325,1278,1758,7877
11,2007-08,MIN,2007-08MIN,82,22,60,0.293,19730,3076,6817,2635,5558,441,1259,1246,1693,964,2428,3392,1630,616,306,1188,1885,7839
10,2008-09,MIN,2008-09MIN,82,24,58,0.329,19805,2986,6766,2443,5227,543,1539,1504,1957,975,2442,3417,1674,512,322,1165,1785,8019
9,2009-10,MIN,2009-10MIN,82,15,67,0.232,19780,3106,6923,2703,5742,403,1181,1436,1926,962,2556,3518,1626,597,306,1333,1699,8051
8,2010-11,MIN,2010-11MIN,82,17,65,0.244,19780,3090,7014,2501,5449,589,1565,1519,1977,1085,2556,3641,1650,592,422,1398,1825,8288
7,2011-12,MIN,2011-12MIN,66,26,40,0.341,15940,2355,5434,1882,4011,473,1423,1281,1662,797,2089,2886,1290,436,293,1001,1212,6464
6,2012-13,MIN,2012-13MIN,82,31,51,0.402,19730,2943,6702,2493,5227,450,1475,1515,2042,973,2473,3446,1836,700,387,1214,1509,7851
5,2013-14,MIN,2013-14MIN,82,40,42,0.5,19855,3189,7175,2589,5418,600,1757,1790,2301,1024,2644,3668,1963,718,297,1142,1504,8768
4,2014-15,MIN,2014-15MIN,82,16,66,0.232,19805,2986,6820,2580,5597,406,1223,1638,2110,949,2406,3355,1771,668,327,1231,1571,8016
3,2015-16,MIN,2015-16MIN,82,29,53,0.378,19880,3095,6668,2640,5321,455,1347,1753,2213,821,2587,3408,1916,656,375,1231,1696,8398
2,2016-17,MIN,2016-17MIN,82,31,51,0.402,19805,3235,6922,2634,5199,601,1723,1586,1986,938,2540,3478,1940,654,370,1150,1646,8657
1,2017-18,MIN,2017-18MIN,7,4,3,0.183,1705,278,600,216,440,62,160,148,185,74,205,279,154,58,26,107,129,766
39,1979-80,NJN,1979-80NJN,82,34,48,0.439,19805,3456,7504,3371,7206,85,298,1882,2406,1229,2535,3764,2094,869,581,1702,2181,
38,1980-81,NJN,1980-81NJN,82,24,58,0.317,19805,3477,7314,3443,7176,34,138,1780,2371,1092,2374,3466,2068,750,458,1664,2204,8768
37,1981-82,NJN,1981-82NJN,82,44,38,0.549,19780,3501,7227,3471,7081,30,146,1714,2354,1194,2320,3514,2096,918,481,1650,2295,8746
36,1982-83,NJN,1982-83NJN,82,49,33,0.61,19705,3510,7140,3480,6991,30,149,1622,2301,1266,2427,3693,2143,911,592,1873,2166,8672
35,1983-84,NJN,1983-84NJN,82,45,37,0.561,19805,3614,7258,3565,7026,49,232,1742,2488,1221,2313,3534,2148,814,499,1608,2243,9019
34,1984-85,NJN,1984-85NJN,82,42,40,0.524,19755,3646,7445,3594,7221,52,224,1631,2237,1233,2325,3558,2163,772,415,1355,2011,8975
33,1985-86,NJN,1985-86NJN,82,39,43,0.5,19805,3548,7301,3505,7087,43,214,1810,2396,1183,2483,3666,2128,749,345,1575,2129,8949
32,1986-87,NJN,1986-87NJN,82,24,58,0.317,19855,3374,7083,3229,6634,145,449,2000,2607,1169,2409,3578,1991,643,397,1617,2353,8893
31,1987-88,NJN,1987-88NJN,82,19,63,0.256,19780,3208,6857,3071,6402,137,455,1682,2308,1075,2262,3337,1795,727,385,1503,2042,8235
30,1988-89,NJN,1988-89NJN,82,26,56,0.341,19805,3333,7226,3146,6658,187,568,1653,2260,1204,2419,3623,1793,773,431,1449,1966,8506
29,1989-90,NJN,1989-90NJN,82,17,65,0.244,19705,3157,7415,3017,6909,140,506,1754,2350,1363,2324,3687,1475,774,481,1360,1952,8208
28,1990-91,NJN,1990-91NJN,82,26,56,0.341,19830,3311,7459,3150,6873,161,586,1658,2245,1400,2348,3748,1782,748,600,1423,1954,8441
27,1991-92,NJN,1991-92NJN,82,40,42,0.5,19780,3473,7580,3249,6910,224,670,1471,2009,1512,2392,3904,1937,736,615,1392,1834,8641
26,1992-93,NJN,1992-93NJN,82,43,39,0.537,19780,3272,7084,3117,6596,155,488,1732,2258,1291,2506,3797,1872,693,526,1355,1892,8431
25,1993-94,NJN,1993-94NJN,82,45,37,0.561,19830,3169,7115,2946,6432,223,683,1900,2495,1300,2556,3856,1900,696,576,1196,1693,8461
24,1994-95,NJN,1994-95NJN,82,30,52,0.39,19880,2939,6738,2525,5441,414,1297,1750,2305,1213,2569,3782,1884,544,548,1300,1844,8042
23,1995-96,NJN,1995-96NJN,82,30,52,0.39,19905,2881,6750,2631,6004,250,746,1672,2244,1350,2503,3853,1752,627,571,1375,1880,7684
22,1996-97,NJN,1996-97NJN,82,26,56,0.341,19780,2994,7091,2510,5720,484,1371,1502,2031,1410,2376,3786,1726,677,481,1290,1865,7974
21,1997-98,NJN,1997-98NJN,82,43,39,0.537,19880,3055,6928,2745,5991,310,937,1750,2351,1344,2137,3481,1685,777,314,1180,1917,8170
20,1998-99,NJN,1998-99NJN,50,16,34,0.232,12050,1691,4160,1466,3481,225,679,962,1251,715,1437,2152,923,491,273,750,1134,4569
19,1999-00,NJN,1999-00NJN,82,31,51,0.402,19830,2979,6881,2502,5507,477,1374,1601,2041,1040,2315,3355,1688,720,393,1119,1913,8036
18,2000-01,NJN,2000-01NJN,82,26,56,0.341,19730,2781,6550,2420,5466,361,1084,1629,2146,909,2337,3246,1603,649,407,1208,1982,7552
17,2001-02,NJN,2001-02NJN,82,52,30,0.646,19830,3042,6816,2639,5622,403,1194,1402,1907,1039,2515,3554,1990,716,490,1189,1734,7889
16,2002-03,NJN,2002-03NJN,82,49,33,0.61,19755,2906,6585,2560,5544,346,1041,1662,2195,991,2528,3519,1887,717,374,1212,1772,7820
15,2003-04,NJN,2003-04NJN,82,47,35,0.585,19705,2813,6372,2436,5249,377,1123,1398,1856,862,2473,3335,2009,709,322,1209,1722,7401
14,2004-05,NJN,2004-05NJN,82,42,40,0.53,19905,2753,6419,2318,5216,435,1203,1555,2039,855,2387,3242,1772,650,308,1164,1985,7496
13,2005-06,NJN,2005-06NJN,82,49,33,0.61,19780,2778,6317,2301,4870,477,1447,1658,2187,822,2539,3361,1884,558,278,1119,1903,7691
12,2006-07,NJN,2006-07NJN,82,41,41,0.512,19880,2913,6379,2304,4703,609,1676,1566,2153,822,2525,3347,1962,499,273,1212,1869,8001
11,2007-08,NJN,2007-08NJN,82,34,48,0.439,19830,2856,6450,2358,5020,498,1430,1647,2237,913,2520,3433,1925,521,390,1229,1855,7857
10,2008-09,NJN,2008-09NJN,82,34,48,0.439,19830,2925,6536,2273,4801,652,1735,1542,1980,850,2415,3265,1636,559,391,1075,1838,8044
9,2009-10,NJN,2009-10NJN,82,12,70,0.207,19780,2813,6554,2436,5369,377,1185,1572,2015,897,2358,3255,1540,573,393,1182,1643,7575
8,2010-11,NJN,2010-11NJN,82,24,58,0.32,20005,2918,6638,2459,5301,459,1337,1427,1881,909,2440,3349,1723,458,384,1152,1807,7722
7,2011-12,NJN,2011-12NJN,66,22,44,0.305,15890,2262,5320,1755,3839,507,1481,1113,1433,783,1879,2662,1311,493,260,995,1268,6144
16,2002-03,NOH,2002-03NOH,82,47,35,0.585,19905,2914,6695,2510,5620,404,1075,1467,1910,1097,2475,3572,1807,656,394,1212,1769,7699
15,2003-04,NOH,2003-04NOH,82,41,41,0.512,19830,2772,6605,2241,4939,531,1666,1454,1937,1091,2418,3509,1716,708,346,1228,1715,7529
14,2004-05,NOH,2004-05NOH,82,18,64,0.256,19930,2718,6556,2303,5240,415,1316,1401,1830,1019,2281,3300,1724,550,310,1217,1883,7252
11,2007-08,NOH,2007-08NOH,82,56,26,0.695,19805,3164,6796,2534,5175,630,1621,1312,1707,937,2494,3431,1785,637,321,974,1531,8270
10,2008-09,NOH,2008-09NOH,82,49,33,0.61,19755,2911,6366,2355,4840,556,1526,1479,1833,802,2453,3255,1609,593,338,1029,1665,7857
9,2009-10,NOH,2009-10NOH,82,37,45,0.476,19830,3178,6842,2607,5270,571,1572,1293,1661,852,2450,3302,1828,625,300,1103,1606,8220
8,2010-11,NOH,2010-11NOH,82,46,36,0.573,19830,2944,6416,2500,5184,444,1232,1452,1897,824,2468,3292,1691,624,359,1069,1719,7784
7,2011-12,NOH,2011-12NOH,66,21,45,0.28,15940,2300,5103,2041,4326,259,777,1057,1397,724,1991,2715,1368,488,316,1024,1324,5916
6,2012-13,NOH,2012-13NOH,82,27,55,0.354,19780,2955,6589,2420,5115,535,1474,1269,1636,988,2426,3414,1721,520,440,1193,1673,7714
13,2005-06,NOK,2005-06NOK,82,38,44,0.488,19805,2831,6428,2531,5543,300,885,1649,2176,918,2379,3297,1519,611,311,1095,1786,7611
12,2006-07,NOK,2006-07NOK,82,39,43,0.5,19880,2971,6674,2516,5418,455,1256,1436,1941,1025,2512,3537,1537,522,347,1187,1620,7833
5,2013-14,NOP,2013-14NOP,82,34,48,0.439,19855,3101,6761,2615,5458,486,1303,1489,1936,933,2486,3419,1745,647,523,1129,1857,8177
4,2014-15,NOP,2014-15NOP,82,45,37,0.573,19780,3108,6795,2522,5212,586,1583,1345,1790,942,2621,3563,1806,553,510,1087,1530,8147
3,2015-16,NOP,2015-16NOP,82,30,52,0.402,19780,3153,7040,2451,5089,702,1951,1415,1823,782,2712,3494,1818,633,342,1102,1713,8423
2,2016-17,NOP,2016-17NOP,82,34,48,0.439,19905,3210,7130,2442,4934,768,2196,1368,1825,703,2879,3582,1869,638,453,1054,1490,8556
1,2017-18,NOP,2017-18NOP,7,3,4,0.171,1680,282,598,207,385,75,213,120,161,69,252,321,169,53,40,119,162,759
39,1979-80,NYK,1979-80NYK,82,39,43,0.488,19780,3802,7672,3760,7481,42,191,1698,2274,1236,2303,3539,2265,881,457,1613,2168,9344
38,1980-81,NYK,1980-81NYK,82,50,32,0.61,19830,3505,7255,3449,7019,56,236,1783,2386,1137,2205,3342,1976,861,314,1461,1917,8849
37,1981-82,NYK,1981-82NYK,82,33,49,0.415,19830,3523,7178,3465,6964,58,214,1603,2171,1168,2273,3441,2075,719,338,1486,2195,8707
36,1982-83,NYK,1982-83NYK,82,44,38,0.549,19805,3272,6793,3239,6662,33,131,1621,2282,1080,2263,3343,2034,701,378,1509,2180,8198
35,1983-84,NYK,1983-84NYK,82,47,35,0.573,19855,3386,6837,3339,6672,47,165,1944,2510,1088,2230,3318,2041,803,360,1587,2281,8763
34,1984-85,NYK,1984-85NYK,82,24,58,0.317,19830,3435,7101,3384,6903,51,198,1706,2350,1116,2102,3218,1999,754,267,1458,2398,8627
33,1985-86,NYK,1985-86NYK,82,23,59,0.305,19805,3239,7034,3157,6795,82,239,1534,2237,1081,2170,3251,1877,714,308,1438,2213,8094
32,1986-87,NYK,1986-87NYK,82,24,58,0.317,19780,3329,7023,3204,6648,125,375,1725,2362,1108,2162,3270,1941,704,396,1420,2028,8508
31,1987-88,NYK,1987-88NYK,82,38,44,0.488,19805,3363,7232,3184,6665,179,567,1750,2306,1286,2194,3480,2012,789,445,1518,2361,8655
30,1988-89,NYK,1988-89NYK,82,52,30,0.646,19805,3701,7611,3315,6464,386,1147,1779,2366,1322,2265,3587,2083,900,446,1572,2053,9567
29,1989-90,NYK,1989-90NYK,82,45,37,0.561,19830,3434,7089,3198,6379,236,710,1775,2349,1187,2426,3613,2140,714,492,1412,1828,8879
28,1990-91,NYK,1990-91NYK,82,39,43,0.5,19955,3308,6822,3123,6264,185,558,1654,2147,1053,2436,3489,2172,638,418,1379,1764,8455
27,1991-92,NYK,1991-92NYK,82,51,31,0.634,19855,3312,6947,3111,6329,201,618,1503,2049,1185,2489,3674,2130,634,382,1242,1905,8328
26,1992-93,NYK,1992-93NYK,82,60,22,0.732,19930,3209,6898,3016,6294,193,604,1717,2316,1150,2660,3810,2125,680,372,1296,2111,8328
25,1993-94,NYK,1993-94NYK,82,57,25,0.695,19755,3098,6735,2782,5827,316,908,1564,2097,1175,2542,3717,2067,752,385,1360,2001,8076
24,1994-95,NYK,1994-95NYK,82,55,27,0.683,19780,2985,6394,2453,4948,532,1446,1552,2114,929,2473,3402,2055,591,387,1305,2102,8054
23,1995-96,NYK,1995-96NYK,82,47,35,0.585,19830,3003,6382,2518,5097,485,1285,1480,1954,829,2449,3278,1822,645,377,1272,1864,7971
22,1996-97,NYK,1996-97NYK,82,57,25,0.695,19855,2882,6227,2412,4933,470,1294,1585,2119,973,2516,3489,1809,629,378,1462,2033,7819
21,1997-98,NYK,1997-98NYK,82,43,39,0.537,19830,2864,6413,2482,5274,382,1139,1399,1812,978,2434,3412,1787,634,278,1247,1947,7509
20,1998-99,NYK,1998-99NYK,50,27,23,0.354,12100,1610,3704,1402,3115,208,589,892,1218,551,1510,2061,963,395,262,804,1140,4320
19,1999-00,NYK,1999-00NYK,82,50,32,0.61,19830,2897,6374,2546,5437,351,937,1410,1805,802,2521,3323,1588,515,349,1201,1983,7555
18,2000-01,NYK,2000-01NYK,82,48,34,0.598,19905,2755,6198,2364,5083,391,1115,1374,1727,773,2524,3297,1520,545,346,1189,1863,7275
17,2001-02,NYK,2001-02NYK,82,30,52,0.39,19805,2817,6520,2343,5176,474,1344,1406,1786,876,2458,3334,1720,558,288,1192,1800,7514
16,2002-03,NYK,2002-03NYK,82,37,45,0.476,19855,2967,6725,2361,5143,606,1582,1320,1620,842,2376,3218,1800,579,255,1149,1888,7860
15,2003-04,NYK,2003-04NYK,82,39,43,0.5,19880,2881,6513,2475,5398,406,1115,1374,1732,950,2543,3493,1695,608,391,1289,1897,7542
14,2004-05,NYK,2004-05NYK,82,33,49,0.427,19880,2978,6599,2537,5359,441,1240,1580,2060,965,2393,3358,1665,629,260,1204,1942,7977
13,2005-06,NYK,2005-06NYK,82,23,59,0.305,19930,2822,6206,2502,5322,320,884,1878,2587,1034,2360,3394,1468,555,271,1449,2157,7842
12,2006-07,NYK,2006-07NYK,82,33,49,0.427,20005,2903,6356,2429,4986,474,1370,1714,2396,1032,2516,3548,1532,543,260,1405,1932,7994
11,2007-08,NYK,2007-08NYK,82,23,59,0.317,19880,2967,6757,2477,5303,490,1454,1524,2095,1029,2457,3486,1530,521,213,1187,1761,7948
10,2008-09,NYK,2008-09NYK,82,32,50,0.415,19805,3157,7091,2334,4807,823,2284,1490,1900,911,2545,3456,1738,610,204,1174,1672,8627
9,2009-10,NYK,2009-10NYK,82,29,53,0.378,19880,3127,6876,2384,4731,743,2145,1376,1759,836,2477,3313,1772,586,305,1148,1638,8373
8,2010-11,NYK,2010-11NYK,82,42,40,0.537,19780,3140,6867,2375,4786,765,2081,1689,2087,847,2470,3317,1757,625,475,1123,1743,8734
7,2011-12,NYK,2011-12NYK,66,36,30,0.463,15940,2365,5335,1848,3797,517,1538,1211,1634,743,2012,2755,1328,622,276,1056,1391,6458
6,2012-13,NYK,2012-13NYK,82,54,28,0.671,19730,2996,6689,2105,4318,891,2371,1313,1729,890,2436,3326,1579,672,294,988,1650,8196
5,2013-14,NYK,2013-14NYK,82,37,45,0.488,19855,3027,6739,2268,4701,759,2038,1271,1670,870,2437,3307,1641,631,367,1063,1815,8084
4,2014-15,NYK,2014-15NYK,82,17,65,0.244,19855,2882,6726,2322,5112,560,1614,1211,1575,867,2443,3310,1746,575,382,1206,1768,7535
3,2015-16,NYK,2015-16NYK,82,32,50,0.415,19805,3022,6886,2412,5124,610,1762,1411,1753,850,2788,3638,1682,467,466,1099,1616,8065
2,2016-17,NYK,2016-17NYK,82,31,51,0.415,19855,3244,7256,2540,5234,704,2022,1364,1731,983,2723,3706,1786,581,455,1139,1668,8556
1,2017-18,NYK,2017-18NYK,6,3,3,0.159,1440,232,514,181,361,51,153,102,137,75,203,278,132,46,30,103,133,617
10,2008-09,OKC,2008-09OKC,82,23,59,0.305,19805,2999,6716,2671,5767,328,949,1626,2069,999,2497,3496,1663,608,371,1330,1655,7952
9,2009-10,OKC,2009-10OKC,82,50,32,0.622,19805,3063,6629,2645,5400,418,1229,1778,2210,960,2607,3567,1639,654,481,1227,1743,8322
8,2010-11,OKC,2010-11OKC,82,55,27,0.683,20005,3066,6609,2579,5206,487,1403,1977,2401,903,2604,3507,1672,654,487,1156,1836,8596
7,2011-12,OKC,2011-12OKC,66,47,19,0.585,15990,2462,5229,1990,3912,472,1317,1406,1744,726,2157,2883,1224,498,539,1079,1352,6802
6,2012-13,OKC,2012-13OKC,82,60,22,0.74,19830,3126,6504,2528,4916,598,1588,1819,2196,854,2725,3579,1753,679,624,1253,1654,8669
5,2013-14,OKC,2013-14OKC,82,59,23,0.732,19805,3194,6782,2530,4943,664,1839,1653,2052,887,2781,3668,1794,678,501,1256,1858,8705
4,2014-15,OKC,2014-15OKC,82,45,37,0.573,19830,3184,7119,2552,5255,632,1864,1524,2020,1052,2844,3896,1681,598,454,1205,1829,8524
3,2015-16,OKC,2015-16OKC,82,55,27,0.683,19830,3372,7082,2694,5137,678,1945,1616,2067,1071,2916,3987,1883,603,487,1305,1691,9038
2,2016-17,OKC,2016-17OKC,82,47,35,0.598,19805,3237,7169,2545,5053,692,2116,1575,2113,1002,2821,3823,1721,648,408,1230,1715,8741
1,2017-18,OKC,2017-18OKC,6,3,3,0.159,1440,242,527,178,336,64,191,88,122,68,183,251,140,69,42,94,133,636
29,1989-90,ORL,1989-90ORL,82,18,64,0.256,19805,3457,7525,3341,7132,116,393,2060,2725,1304,2465,3769,1993,617,294,1407,1975,909
28,1990-91,ORL,1990-91ORL,82,31,51,0.402,19780,3298,7256,3028,6502,270,754,1818,2447,1233,2429,3662,1809,602,306,1391,1976,8684
27,1991-92,ORL,1991-92ORL,82,21,61,0.28,19705,3220,7102,3023,6494,197,608,1693,2268,1171,2329,3500,1792,643,367,1389,1977,8330
26,1992-93,ORL,1992-93ORL,82,41,41,0.512,19880,3257,6708,2940,5819,317,889,1821,2495,1040,2566,3606,1952,542,467,1429,1925,8652
25,1993-94,ORL,1993-94ORL,82,50,32,0.621,19730,3341,6883,2947,5746,394,1137,1590,2346,1177,2356,3533,2070,683,456,1327,1713,8666
24,1994-95,ORL,1994-95ORL,82,57,25,0.697,19930,3460,6899,2937,5487,523,1412,1648,2465,1149,2457,3606,2281,672,488,1297,1726,9091
23,1995-96,ORL,1995-96ORL,82,60,22,0.74,19855,3203,6640,2581,4995,622,1645,1543,2232,966,2401,3367,2080,663,406,1160,1709,8571
22,1996-97,ORL,1996-97ORL,82,45,37,0.573,19855,2839,6497,2272,4835,567,1662,1474,1975,1071,2221,3292,1689,694,363,1250,1643,7719
21,1997-98,ORL,1997-98ORL,82,41,41,0.512,19830,2771,6455,2478,5548,293,907,1552,2138,1178,2203,3381,1694,649,441,1258,1617,7387
20,1998-99,ORL,1998-99ORL,50,33,17,0.415,12050,1687,3943,1464,3268,223,675,876,1252,688,1445,2133,1067,496,213,819,935,4473
19,1999-00,ORL,1999-00ORL,82,41,41,0.512,19755,3169,7014,2875,6144,294,870,1574,2142,1145,2540,3685,1709,743,467,1443,1967,8206
18,2000-01,ORL,2000-01ORL,82,43,39,0.537,19955,3013,6873,2523,5527,490,1346,1476,2068,1069,2450,3519,1803,674,481,1245,2071,7992
17,2001-02,ORL,2001-02ORL,82,44,38,0.549,19830,3087,6893,2467,5233,620,1660,1446,1917,942,2440,3382,1804,665,384,1119,1700,8240
16,2002-03,ORL,2002-03ORL,82,42,40,0.537,19805,2947,6763,2379,5173,568,1590,1616,2079,958,2392,3350,1676,696,300,1177,1888,8078
15,2003-04,ORL,2003-04ORL,82,21,61,0.293,19830,2904,6768,2475,5520,429,1248,1474,2000,1003,2350,3353,1584,547,308,1123,1744,7711
14,2004-05,ORL,2004-05ORL,82,36,46,0.463,19705,3034,6679,2714,5763,320,916,1772,2335,1038,2544,3582,1583,633,441,1322,1937,8160
13,2005-06,ORL,2005-06ORL,82,36,46,0.463,19905,2911,6167,2612,5371,299,796,1663,2277,892,2402,3294,1495,532,362,1240,1908,7784
12,2006-07,ORL,2006-07ORL,82,40,42,0.5,19780,2875,6090,2533,5128,342,962,1679,2393,920,2418,3338,1525,565,416,1392,1904,7771
11,2007-08,ORL,2007-08ORL,82,52,30,0.646,19780,3058,6446,2257,4372,801,2074,1650,2288,768,2677,3445,1706,520,333,1173,1688,8567
10,2008-09,ORL,2008-09ORL,82,59,23,0.732,19730,2929,6416,2112,4269,817,2147,1611,2253,819,2728,3547,1593,570,439,1142,1664,8286
9,2009-10,ORL,2009-10ORL,82,59,23,0.732,19730,3005,6394,2164,4153,841,2241,1575,2176,810,2736,3546,1615,512,456,1155,1629,8426
8,2010-11,ORL,2010-11ORL,82,52,30,0.646,19830,2956,6411,2186,4308,770,2103,1453,2101,864,2679,3543,1636,548,384,1224,1640,8135
7,2011-12,ORL,2011-12ORL,66,37,29,0.476,15965,2275,5162,1605,3377,670,1785,995,1508,742,2060,2802,1321,451,275,984,1168,6215
6,2012-13,ORL,2012-13ORL,82,20,62,0.28,19780,3093,6904,2587,5367,506,1537,1026,1359,890,2612,3502,1871,528,358,1191,1591,7718
5,2013-14,ORL,2013-14ORL,82,23,59,0.317,19955,3022,6784,2459,5188,563,1596,1307,1714,794,2654,3448,1726,630,350,1222,1678,7914
4,2014-15,ORL,2014-15ORL,82,25,57,0.341,19755,3076,6792,2522,5194,554,1598,1141,1565,822,2607,3429,1692,647,314,1221,1714,7847
3,2015-16,ORL,2015-16ORL,82,35,47,0.451,19905,3242,7120,2606,5302,636,1818,1249,1649,843,2709,3552,1933,673,417,1155,1701,8369
2,2016-17,ORL,2016-17ORL,82,29,53,0.378,19805,3139,7133,2438,4994,701,2139,1309,1753,807,2734,3541,1820,580,396,1091,1584,8288
1,2017-18,ORL,2017-18ORL,7,5,2,0.183,1680,301,618,212,416,89,202,127,162,59,254,313,177,61,37,107,159,818
39,1979-80,PHI,1979-80PHI,82,59,23,0.72,19855,3523,7156,3496,7031,27,125,1876,2431,1187,2635,3822,2226,792,652,1708,1860,8949
38,1980-81,PHI,1980-81PHI,82,62,20,0.756,19855,3636,7073,3617,6989,19,84,1865,2427,1091,2618,3709,2369,857,591,1702,2061,9156
37,1981-82,PHI,1981-82PHI,82,58,24,0.707,19855,3616,6974,3575,6835,41,139,1846,2471,1031,2389,3420,2264,856,622,1474,2183,9119
36,1982-83,PHI,1982-83PHI,82,65,17,0.793,19830,3600,7212,3575,7103,25,109,1966,2650,1334,2596,3930,2016,812,577,1627,2041,9191
35,1983-84,PHI,1983-84PHI,82,52,30,0.636,19955,3384,6833,3355,6726,29,107,2041,2706,1181,2382,3563,2032,807,653,1628,2040,8838
34,1984-85,PHI,1984-85PHI,82,58,24,0.707,19805,3443,6992,3384,6768,59,224,2316,2883,1301,2364,3665,1999,817,534,1575,1971,9261
33,1985-86,PHI,1985-86PHI,82,54,28,0.659,19905,3435,7058,3384,6834,51,224,2130,2810,1326,2378,3704,2017,862,490,1595,1798,9051
32,1986-87,PHI,1986-87PHI,82,45,37,0.561,19880,3335,6792,3247,6452,88,340,1971,2617,1178,2327,3505,1943,768,540,1519,1774,8729
31,1987-88,PHI,1987-88PHI,82,36,46,0.451,19905,3214,6785,3062,6314,152,471,2087,2731,1219,2307,3526,1897,672,465,1433,1866,8667
30,1988-89,PHI,1988-89PHI,82,46,36,0.573,19780,3500,7201,3296,6555,204,646,1970,2504,1143,2356,3499,2110,689,354,1214,1721,9174
29,1989-90,PHI,1989-90PHI,82,53,29,0.659,19805,3437,7028,3248,6485,189,543,1976,2509,1111,2406,3517,1932,687,365,1209,1697,9039
28,1990-91,PHI,1990-91PHI,82,44,38,0.549,20080,3289,6925,3094,6307,195,618,1868,2366,984,2496,3480,1824,678,479,1230,1629,8641
27,1991-92,PHI,1991-92PHI,82,35,47,0.451,19755,3187,6761,2960,6081,227,680,1757,2267,1058,2309,3367,1755,692,482,1238,1582,8358
26,1992-93,PHI,1992-93PHI,82,26,56,0.341,19930,3225,7075,2895,6134,330,941,1776,2259,1031,2431,3462,2038,672,566,1362,1604,8556
25,1993-94,PHI,1993-94PHI,82,25,57,0.333,19805,3103,6819,2785,5877,318,942,1509,2112,1012,2394,3406,1827,663,525,1368,1488,8033
24,1994-95,PHI,1994-95PHI,82,24,58,0.317,19805,2949,6577,2594,5641,355,936,1567,2125,1105,2230,3335,1566,643,576,1355,1835,7820
23,1995-96,PHI,1995-96PHI,82,18,64,0.256,19730,2796,6418,2304,4980,492,1438,1662,2263,1031,2161,3192,1629,643,420,1414,1777,7746
22,1996-97,PHI,1996-97PHI,82,22,60,0.303,19780,3003,6850,2570,5494,433,1356,1776,2450,1267,2355,3622,1695,683,394,1437,1733,8215
21,1997-98,PHI,1997-98PHI,82,31,51,0.402,19755,2837,6409,2594,5599,243,810,1734,2352,1125,2294,3419,1729,729,490,1354,1878,7651
20,1998-99,PHI,1998-99PHI,50,28,22,0.366,12150,1656,3883,1558,3512,98,371,1073,1486,729,1428,2157,934,542,271,822,1152,4483
19,1999-00,PHI,1999-00PHI,82,49,33,0.61,19830,2993,6776,2785,6133,208,643,1577,2226,1147,2468,3615,1817,791,386,1284,1939,7771
18,2000-01,PHI,2000-01PHI,82,56,26,0.683,19855,2902,6487,2640,5684,262,803,1697,2277,1075,2600,3675,1692,690,408,1292,1673,7763
17,2001-02,PHI,2001-02PHI,82,43,39,0.537,19730,2804,6436,2590,5721,214,715,1639,2104,1092,2534,3626,1638,705,363,1256,1645,7461
16,2002-03,PHI,2002-03PHI,82,48,34,0.598,19855,2975,6640,2730,5853,245,787,1746,2253,1042,2415,3457,1771,844,284,1212,1804,7941
15,2003-04,PHI,2003-04PHI,82,33,49,0.427,19855,2682,6260,2343,5268,339,992,1512,2009,941,2408,3349,1640,654,358,1307,1701,7215
14,2004-05,PHI,2004-05PHI,82,43,39,0.54,19855,2946,6736,2441,5283,505,1453,1731,2194,909,2536,3445,1710,756,321,1274,1878,8128
13,2005-06,PHI,2005-06PHI,82,38,44,0.488,19905,3001,6546,2626,5515,375,1031,1770,2330,873,2425,3298,1653,651,404,1159,1712,8147
12,2006-07,PHI,2006-07PHI,82,35,47,0.451,19880,2932,6408,2648,5585,284,823,1637,2135,899,2353,3252,1669,590,390,1258,1671,7785
11,2007-08,PHI,2007-08PHI,82,40,42,0.5,19755,3056,6648,2754,5696,302,952,1509,2137,1067,2370,3437,1673,712,400,1172,1620,7923
10,2008-09,PHI,2008-09PHI,82,41,41,0.512,19755,2997,6532,2656,5460,341,1072,1652,2216,1039,2336,3375,1647,658,415,1157,1650,7987
9,2009-10,PHI,2009-10PHI,82,27,55,0.354,19805,3087,6706,2613,5325,474,1381,1366,1808,941,2421,3362,1723,667,439,1192,1677,8014
8,2010-11,PHI,2010-11PHI,82,41,41,0.512,19930,3125,6776,2682,5528,443,1248,1426,1851,850,2578,3428,1861,621,355,1063,1592,8119
7,2011-12,PHI,2011-12PHI,66,35,31,0.451,15915,2471,5516,2122,4553,349,963,889,1198,704,2144,2848,1453,526,340,738,1157,6180
6,2012-13,PHI,2012-13PHI,82,34,48,0.439,19755,3059,6895,2541,5457,518,1438,1004,1377,896,2493,3389,1867,609,384,1070,1505,7640
5,2013-14,PHI,2013-14PHI,82,19,63,0.268,19855,3108,7150,2531,5303,577,1847,1362,1918,949,2556,3505,1791,765,330,1384,1844,8155
4,2014-15,PHI,2014-15PHI,82,18,64,0.256,19805,2765,6777,2073,4617,692,2160,1320,1953,978,2536,3514,1683,789,487,1453,1778,7542
3,2015-16,PHI,2015-16PHI,82,10,72,0.207,19805,2970,6887,2206,4632,764,2255,1284,1850,777,2605,3382,1765,680,495,1343,1780,7988
2,2016-17,PHI,2016-17PHI,82,28,54,0.366,19830,3088,6992,2257,4549,831,2443,1393,1806,807,2706,3513,1949,692,420,1366,1793,8400
1,2017-18,PHI,2017-18PHI,7,3,4,0.167,1680,275,607,195,397,80,210,99,143,71,247,318,169,63,26,126,179,729
39,1979-80,PHO,1979-80PHO,82,55,27,0.671,19755,3570,7235,3502,6955,68,280,1906,2466,1071,2458,3529,2283,908,344,1629,1853,9114
38,1980-81,PHO,1980-81PHO,82,57,25,0.695,19755,3587,7326,3552,7165,35,161,1810,2430,1234,2490,3724,2205,876,416,1733,1996,9019
37,1981-82,PHO,1981-82PHO,82,46,36,0.573,19830,3508,7140,3454,6966,54,174,1635,2157,1123,2517,3640,2223,753,429,1528,2029,8705
36,1982-83,PHO,1982-83PHO,82,53,29,0.646,19730,3555,7158,3515,7000,40,158,1626,2189,1094,2518,3612,2300,749,495,1545,2062,8776
35,1983-84,PHO,1983-84PHO,82,41,41,0.5,19780,3677,7220,3603,6929,74,291,1673,2204,1066,2298,3364,2214,693,388,1451,2147,9101
34,1984-85,PHO,1984-85PHO,82,36,46,0.451,19805,3507,7144,3420,6837,87,307,1757,2280,1026,2425,3451,2335,727,349,1583,2034,8858
33,1985-86,PHO,1985-86PHO,82,32,50,0.415,19805,3518,6993,3480,6810,38,183,1949,2683,1034,2449,3483,2272,773,379,1763,2260,9023
32,1986-87,PHO,1986-87PHO,82,36,46,0.451,19855,3575,7190,3514,6938,61,252,1900,2499,1113,2366,3479,2354,703,397,1498,2047,9111
31,1987-88,PHO,1987-88PHO,82,28,54,0.366,19730,3551,7302,3433,6945,118,357,1681,2200,1113,2379,3492,2332,675,353,1413,2045,8901
30,1988-89,PHO,1988-89PHO,82,55,27,0.671,19755,3754,7545,3586,7064,168,481,2051,2594,1095,2619,3714,2280,693,416,1279,1933,9727
29,1989-90,PHO,1989-90PHO,82,54,28,0.66,19855,3544,7139,3368,6596,176,543,2159,2716,1053,2651,3704,2109,668,501,1275,1825,9423
28,1990-91,PHO,1990-91PHO,82,55,27,0.671,19730,3573,7199,3435,6767,138,432,2064,2680,1132,2598,3730,2209,687,535,1302,1850,9348
27,1991-92,PHO,1991-92PHO,82,53,29,0.659,19805,3553,7219,3326,6623,227,596,1861,2397,1088,2558,3646,2202,673,582,1242,1852,9194
26,1992-93,PHO,1992-93PHO,82,62,20,0.756,19730,3494,7093,3096,5998,398,1095,1912,2539,1141,2510,3651,2087,752,455,1359,1739,9298
25,1993-94,PHO,1993-94PHO,82,56,26,0.683,19705,3429,7080,3085,6038,344,1042,1674,2301,1220,2453,3673,2261,745,460,1305,1639,8876
24,1994-95,PHO,1994-95PHO,82,59,23,0.732,19830,3356,6967,2772,5383,584,1584,1777,2352,1027,2403,3430,2198,687,312,1167,1839,9073
23,1995-96,PHO,1995-96PHO,82,41,41,0.512,19955,3159,6673,2832,5689,327,984,1907,2472,1009,2501,3510,2001,623,331,1207,1776,8552
22,1996-97,PHO,1996-97PHO,82,40,42,0.5,19855,3143,6705,2616,5277,527,1428,1618,2125,916,2376,3292,2067,664,322,1180,1727,8431
21,1997-98,PHO,1997-98PHO,82,56,26,0.683,19955,3138,6710,2707,5499,431,1211,1459,1948,991,2452,3443,2124,756,429,1236,1765,8166
20,1998-99,PHO,1998-99PHO,50,27,23,0.354,12050,1797,4004,1536,3302,261,702,924,1215,598,1418,2016,1249,444,200,681,1022,4779
19,1999-00,PHO,1999-00PHO,82,53,29,0.659,19805,3093,6771,2635,5525,458,1246,1467,1934,1022,2558,3580,2098,744,433,1368,1973,8111
18,2000-01,PHO,2000-01PHO,82,51,31,0.634,19805,2944,6757,2612,5703,332,1054,1490,1973,970,2529,3499,1905,775,429,1250,1864,7710
17,2001-02,PHO,2001-02PHO,82,36,46,0.463,19830,3097,6934,2739,5838,358,1096,1250,1630,1072,2430,3502,1838,668,401,1205,1785,7802
16,2002-03,PHO,2002-03PHO,82,44,38,0.549,19805,3005,6776,2611,5627,394,1149,1430,1928,1049,2440,3489,1719,665,404,1208,1801,7834
15,2003-04,PHO,2003-04PHO,82,29,53,0.378,19730,2958,6671,2543,5469,415,1202,1392,1865,924,2406,3330,1586,734,383,1249,1862,7723
14,2004-05,PHO,2004-05PHO,82,62,20,0.758,19780,3351,7018,2555,4992,796,2026,1556,2080,967,2652,3619,1927,572,453,1125,1563,9054
13,2005-06,PHO,2005-06PHO,82,54,28,0.671,19955,3430,7167,2593,5070,837,2097,1189,1475,778,2650,3428,2179,549,412,1088,1683,8886
12,2006-07,PHO,2006-07PHO,82,61,21,0.756,19905,3388,6855,2603,4890,785,1965,1476,1827,737,2583,3320,2122,553,394,1189,1659,9037
11,2007-08,PHO,2007-08PHO,82,55,27,0.683,19780,3392,6782,2698,5018,694,1764,1548,1977,720,2683,3403,2188,532,518,1184,1633,9026
10,2008-09,PHO,2008-09PHO,82,46,36,0.573,19755,3373,6695,2820,5250,553,1445,1675,2251,900,2520,3420,1905,589,420,1288,1691,8974
9,2009-10,PHO,2009-10PHO,82,54,28,0.671,19730,3339,6788,2609,5018,730,1770,1631,2117,910,2616,3526,1912,479,418,1210,1713,9039
8,2010-11,PHO,2010-11PHO,82,40,42,0.5,20005,3219,6844,2518,4987,701,1857,1472,1939,821,2478,3299,1945,545,357,1169,1666,8611
7,2011-12,PHO,2011-12PHO,66,33,33,0.427,15840,2495,5445,2051,4150,444,1295,1058,1397,717,2035,2752,1486,431,366,928,1233,6492
6,2012-13,PHO,2012-13PHO,82,25,57,0.341,19805,3061,6917,2581,5462,480,1455,1203,1618,959,2454,3413,1855,659,434,1278,1688,7805
5,2013-14,PHO,2013-14PHO,82,48,34,0.605,19755,3172,6845,2407,4790,765,2055,1520,2004,928,2601,3529,1563,688,374,1258,1798,8629
4,2014-15,PHO,2014-15PHO,82,39,43,0.5,19880,3178,7038,2480,4990,698,2048,1343,1767,896,2643,3539,1659,700,385,1238,1744,8397
3,2015-16,PHO,2015-16PHO,82,23,59,0.317,19705,3051,7018,2313,4900,738,2118,1431,1905,943,2733,3676,1701,632,313,1410,1858,8271
2,2016-17,PHO,2016-17PHO,82,24,58,0.329,19830,3270,7260,2655,5406,615,1854,1676,2159,976,2712,3688,1604,673,399,1265,2030,8831
1,2017-18,PHO,2017-18PHO,6,2,4,0.143,1440,221,512,169,357,52,155,121,160,58,207,265,105,51,37,110,146,615
39,1979-80,POR,1979-80POR,82,38,44,0.488,19780,3408,7167,3382,7035,26,132,1560,2100,1295,2408,3703,1898,708,472,1552,1956,8402
38,1980-81,POR,1980-81POR,82,45,37,0.561,19855,3741,7535,3716,7387,25,148,1573,2191,1243,2388,3631,2244,769,480,1518,2034,9080
37,1981-82,POR,1981-82POR,82,42,40,0.524,19780,3629,7187,3600,7047,29,140,1719,2387,1142,2355,3497,2054,706,367,1390,2012,9006
36,1982-83,POR,1982-83POR,82,46,36,0.573,19755,3459,7124,3424,6974,35,150,1855,2512,1180,2380,3560,2030,749,384,1495,1960,8808
35,1983-84,POR,1983-84POR,82,48,34,0.598,19805,3632,7189,3607,7060,25,129,1988,2637,1251,2194,3445,2082,814,397,1483,2134,9277
34,1984-85,POR,1984-85POR,82,42,40,0.524,19880,3708,7374,3657,7172,51,202,2002,2667,1202,2298,3500,2225,821,516,1481,1957,9469
33,1985-86,POR,1985-86POR,82,40,42,0.5,19855,3610,7281,3536,7006,74,275,2142,2799,1153,2316,3469,2180,859,356,1529,2205,9436
32,1986-87,POR,1986-87POR,82,49,33,0.61,19805,3650,7249,3552,6910,98,339,2269,2928,1180,2413,3593,2359,767,387,1546,2082,9667
31,1987-88,POR,1987-88POR,82,53,29,0.659,19730,3661,7460,3544,7080,117,380,2079,2701,1251,2491,3742,2307,726,347,1351,2091,9518
30,1988-89,POR,1988-89POR,82,39,43,0.5,19830,3695,7795,3479,7150,216,645,1789,2416,1384,2381,3765,2212,828,388,1435,2026,9395
29,1989-90,POR,1989-90POR,82,59,23,0.72,19880,3572,7547,3382,6982,190,565,2031,2734,1355,2552,3907,2085,749,364,1356,2048,9365
28,1990-91,POR,1990-91POR,82,63,19,0.768,19905,3577,7369,3236,6465,341,904,1912,2538,1202,2561,3763,2254,724,410,1309,1975,9407
27,1991-92,POR,1991-92POR,82,57,25,0.695,19880,3476,7352,3151,6408,325,944,1858,2463,1294,2549,3843,2065,753,410,1328,1983,9135
26,1992-93,POR,1992-93POR,82,51,31,0.634,19905,3361,7343,3086,6500,275,843,1901,2551,1226,2507,3733,1969,770,425,1215,1892,8898
25,1993-94,POR,1993-94POR,82,47,35,0.585,19755,3371,7427,3099,6657,272,770,1781,2396,1302,2460,3762,2070,744,409,1210,1827,8795
24,1994-95,POR,1994-95POR,82,44,38,0.549,19705,3217,7134,2755,5868,462,1266,1555,2230,1352,2443,3795,1846,668,467,1212,2024,8451
23,1995-96,POR,1995-96POR,82,44,38,0.549,19905,3064,6688,2584,5330,480,1358,1537,2321,1160,2577,3737,1760,594,417,1377,1859,8145
22,1996-97,POR,1996-97POR,82,49,33,0.61,19855,3000,6465,2499,5064,501,1401,1613,2261,1058,2494,3552,1710,640,435,1357,1928,8114
21,1997-98,POR,1997-98POR,82,46,36,0.573,19830,2885,6397,2561,5350,324,1047,1640,2226,1086,2522,3608,1766,585,464,1383,1859,7734
20,1998-99,POR,1998-99POR,50,35,15,0.451,12175,1747,3956,1501,3281,246,675,1002,1349,646,1570,2216,1073,411,290,771,1126,4742
19,1999-00,POR,1999-00POR,82,59,23,0.72,19780,3021,6430,2614,5302,407,1128,1542,2029,966,2560,3526,1925,633,396,1243,1865,7991
18,2000-01,POR,2000-01POR,82,50,32,0.62,19780,3004,6417,2635,5360,369,1057,1447,1899,960,2481,3441,1963,672,419,1257,1745,7824
17,2001-02,POR,2001-02POR,82,49,33,0.61,19830,3004,6671,2538,5353,466,1318,1451,1901,1085,2444,3529,1926,702,368,1172,1613,7925
16,2002-03,POR,2002-03POR,82,50,32,0.622,19855,2987,6491,2608,5341,379,1150,1450,1947,992,2378,3370,1860,725,316,1248,1634,7803
15,2003-04,POR,2003-04POR,82,41,41,0.512,19980,2898,6467,2517,5365,381,1102,1263,1728,1040,2376,3416,1768,613,443,1213,1554,7440
14,2004-05,POR,2004-05POR,82,27,55,0.354,19730,2896,6422,2476,5261,420,1161,1409,1944,970,2404,3374,1722,583,544,1308,1703,7621
13,2005-06,POR,2005-06POR,82,21,61,0.293,19730,2791,6267,2427,5225,364,1042,1339,1944,886,2203,3089,1490,529,435,1205,1828,7285
12,2006-07,POR,2006-07POR,82,32,50,0.415,19955,2874,6392,2448,5160,426,1232,1543,2006,923,2299,3222,1513,555,380,1236,1931,7717
11,2007-08,POR,2007-08POR,82,41,41,0.512,19905,2935,6546,2397,5120,538,1426,1412,1841,901,2438,3339,1733,455,360,1056,1642,7820
10,2008-09,POR,2008-09POR,82,54,28,0.671,19830,3018,6494,2422,4939,596,1555,1521,1988,1060,2360,3420,1667,550,402,1055,1671,8153
9,2009-10,POR,2009-10POR,82,50,32,0.622,19855,2974,6453,2483,5065,491,1388,1606,2033,913,2383,3296,1674,523,350,1012,1715,8045
8,2010-11,POR,2010-11POR,82,48,34,0.598,19805,2951,6599,2433,5096,518,1503,1476,1835,996,2230,3226,1736,660,358,1070,1585,7896
7,2011-12,POR,2011-12POR,66,28,38,0.366,15965,2402,5417,1924,4035,478,1382,1133,1423,735,1949,2684,1349,528,322,935,1251,6415
6,2012-13,POR,2012-13POR,82,33,49,0.429,19855,3009,6715,2336,4811,673,1904,1304,1680,874,2474,3348,1784,538,353,1203,1518,7995
5,2013-14,POR,2013-14POR,82,54,28,0.671,19855,3207,7134,2437,5063,770,2071,1569,1926,1022,2786,3808,1904,454,387,1125,1576,8753
4,2014-15,POR,2014-15POR,82,51,31,0.634,19855,3175,7049,2368,4818,807,2231,1272,1589,879,2881,3760,1799,525,372,1117,1494,8429
3,2015-16,POR,2015-16POR,82,44,38,0.561,19805,3167,7040,2303,4704,864,2336,1424,1889,948,2782,3730,1748,562,380,1200,1782,8622
2,2016-17,POR,2016-17POR,82,41,41,0.512,19930,3243,7059,2391,4787,852,2272,1513,1940,830,2750,3580,1733,574,408,1126,1736,8851
1,2017-18,POR,2017-18POR,7,4,3,0.183,1680,263,613,186,431,77,182,150,182,91,257,348,135,48,44,100,157,753
33,1985-86,SAC,1985-86SAC,82,37,45,0.463,19780,3538,7220,3508,7086,30,134,1818,2338,1135,2377,3512,2304,602,388,1533,2134,8924
32,1986-87,SAC,1986-87SAC,82,29,53,0.378,19780,3522,7413,3445,7106,77,307,1974,2479,1282,2441,3723,2185,513,397,1403,2007,9095
31,1987-88,SAC,1987-88SAC,82,24,58,0.317,19780,3458,7337,3314,6887,144,450,1795,2324,1232,2461,3693,2116,582,493,1457,1895,8855
30,1988-89,SAC,1988-89SAC,82,27,55,0.354,19780,3362,7351,3055,6527,307,824,1620,2104,1141,2454,3595,1970,624,409,1370,1877,8651
29,1989-90,SAC,1989-90SAC,82,23,59,0.305,19755,3305,7056,3089,6407,216,649,1515,1964,952,2363,3315,2052,546,392,1239,1863,8341
28,1990-91,SAC,1990-91SAC,82,25,57,0.329,19705,3086,6818,2870,6240,216,578,1540,2105,1027,2218,3245,1991,631,513,1272,2075,7928
27,1991-92,SAC,1991-92SAC,82,29,53,0.378,19830,3348,7189,3110,6514,238,675,1615,2162,1054,2354,3408,1957,727,618,1360,1763,8549
26,1992-93,SAC,1992-93SAC,82,25,57,0.329,19780,3360,7264,3098,6476,262,788,1865,2447,1137,2281,3418,2075,768,348,1364,2085,8847
25,1993-94,SAC,1993-94SAC,82,28,54,0.366,19755,3179,7027,2922,6298,257,729,1676,2292,1122,2349,3471,2029,669,355,1333,1979,8291
24,1994-95,SAC,1994-95SAC,82,39,43,0.5,19855,3025,6463,2666,5426,359,1037,1647,2317,1073,2325,3398,1824,650,457,1449,2040,8056
23,1995-96,SAC,1995-96SAC,82,39,43,0.5,19755,2971,6494,2509,5300,462,1194,1759,2407,1114,2345,3459,1829,643,436,1442,2131,8163
22,1996-97,SAC,1996-97SAC,82,34,48,0.439,19855,3000,6611,2586,5553,414,1058,1494,2067,1100,2307,3407,1799,588,362,1332,1946,7908
21,1997-98,SAC,1997-98SAC,82,27,55,0.354,19730,2957,6684,2674,5878,283,806,1440,2096,1094,2304,3398,1836,596,420,1271,1810,7637
20,1998-99,SAC,1998-99SAC,50,27,23,0.354,12200,1918,4307,1628,3364,290,943,883,1293,706,1573,2279,1129,444,232,842,1016,5009
19,1999-00,SAC,1999-00SAC,82,44,38,0.549,19805,3276,7288,2742,5632,534,1656,1521,2016,1056,2635,3691,1953,787,381,1325,1729,8607
18,2000-01,SAC,2000-01SAC,82,55,27,0.683,20080,3132,6969,2653,5616,479,1353,1600,2075,987,2705,3692,1852,793,432,1221,1596,8343
17,2001-02,SAC,2001-02SAC,82,61,21,0.744,19755,3267,7003,2841,5843,426,1160,1618,2154,1013,2702,3715,1958,741,375,1128,1560,8578
16,2002-03,SAC,2002-03SAC,82,59,23,0.72,19830,3242,6990,2751,5702,491,1288,1367,1832,900,2751,3651,2034,736,457,1192,1666,8342
15,2003-04,SAC,2003-04SAC,82,55,27,0.683,19780,3103,6711,2502,5213,601,1498,1626,2044,888,2492,3380,2152,710,325,1137,1586,8433
14,2004-05,SAC,2004-05SAC,82,50,32,0.622,19855,3203,6978,2681,5582,522,1396,1577,2004,1023,2455,3478,2005,674,316,1073,1685,8505
13,2005-06,SAC,2005-06SAC,82,44,38,0.549,19830,2954,6500,2460,5092,494,1408,1704,2173,852,2473,3325,1825,608,299,1199,1672,8106
12,2006-07,SAC,2006-07SAC,82,33,49,0.427,19805,2941,6532,2411,5019,530,1513,1891,2473,797,2396,3193,1665,671,265,1194,1792,8303
11,2007-08,SAC,2007-08SAC,82,38,44,0.488,19830,3043,6558,2533,5191,510,1367,1812,2272,829,2456,3285,1567,651,334,1317,1839,8408
10,2008-09,SAC,2008-09SAC,82,17,65,0.244,19905,2990,6685,2404,5091,586,1594,1682,2107,840,2366,3206,1619,569,349,1266,1910,8248
9,2009-10,SAC,2009-10SAC,82,25,57,0.333,19880,3144,6895,2662,5512,482,1383,1430,1969,977,2518,3495,1679,564,366,1226,1827,8200
8,2010-11,SAC,2010-11SAC,82,24,58,0.317,19855,3134,6979,2706,5702,428,1277,1455,1981,1071,2526,3597,1675,608,391,1324,1805,8151
7,2011-12,SAC,2011-12SAC,66,22,44,0.293,15915,2490,5712,2079,4411,411,1301,1127,1532,882,1947,2829,1271,561,323,952,1287,6518
6,2012-13,SAC,2012-13SAC,82,28,54,0.366,19830,3086,6904,2476,5223,610,1681,1437,1869,943,2385,3328,1708,671,342,1199,1717,8219
5,2013-14,SAC,2013-14SAC,82,28,54,0.366,19830,3026,6766,2535,5291,491,1475,1698,2237,990,2656,3646,1547,587,318,1249,1849,8241
4,2014-15,SAC,2014-15SAC,82,29,53,0.378,19855,3010,6617,2549,5267,461,1350,1829,2400,895,2728,3623,1667,550,324,1333,1696,8310
3,2015-16,SAC,2015-16SAC,82,33,49,0.429,19805,3283,7083,2623,5244,660,1839,1514,2089,868,2760,3628,2009,733,368,1326,1676,8740
2,2016-17,SAC,2016-17SAC,82,32,50,0.415,19880,3105,6734,2368,4774,737,1960,1483,1913,715,2652,3367,1844,627,324,1201,1667,8430
1,2017-18,SAC,2017-18SAC,6,1,5,0.106,1440,223,522,175,389,48,133,82,106,66,186,252,111,47,19,89,121,576
39,1979-80,SAS,1979-80SAS,82,41,41,0.5,19755,3856,7738,3804,7532,52,206,2024,2528,1153,2515,3668,2326,771,333,1589,2103,9788
38,1980-81,SAS,1980-81SAS,82,52,30,0.634,19805,3571,7276,3556,7191,15,85,2052,2668,1304,2582,3886,2048,685,643,1533,2114,9209
37,1981-82,SAS,1981-82SAS,82,48,34,0.598,19755,3698,7613,3634,7361,64,252,1812,2335,1253,2537,3790,2257,600,555,1293,2217,9272
36,1982-83,SAS,1982-83SAS,82,53,29,0.646,19780,3697,7340,3603,7032,94,308,1887,2468,1232,2599,3831,2261,675,469,1504,2095,9375
35,1983-84,SAS,1983-84SAS,82,37,45,0.476,19980,3909,7721,3830,7458,79,263,1965,2604,1230,2528,3758,2361,685,491,1447,2146,9862
34,1984-85,SAS,1984-85SAS,82,41,41,0.5,19780,3698,7202,3643,7000,55,202,1961,2571,1127,2470,3597,2316,757,443,1542,2180,9412
33,1985-86,SAS,1985-86SAS,82,35,47,0.439,19805,3596,7104,3550,6908,46,196,1882,2523,1069,2413,3482,2260,800,390,1624,2115,9120
32,1986-87,SAS,1986-87SAS,82,28,54,0.366,19805,3532,7456,3415,7053,117,403,1701,2292,1285,2347,3632,2220,786,325,1406,1930,8882
31,1987-88,SAS,1987-88SAS,82,31,51,0.402,19805,3706,7559,3573,7147,133,412,1769,2412,1184,2335,3519,2344,739,468,1418,1991,9314
30,1988-89,SAS,1988-89SAS,82,21,61,0.28,19755,3469,7409,3406,7116,63,293,1651,2367,1295,2181,3476,2037,961,423,1712,2153,8652
29,1989-90,SAS,1989-90SAS,82,56,26,0.683,19730,3388,6997,3334,6771,54,226,1888,2535,1163,2474,3637,2037,799,554,1399,1854,8718
28,1990-91,SAS,1990-91SAS,82,55,27,0.671,19830,3409,6988,3328,6691,81,297,1883,2459,1131,2657,3788,2140,670,571,1445,1896,8782
27,1991-92,SAS,1991-92SAS,82,47,35,0.58,19780,3377,7090,3259,6686,118,404,1652,2246,1229,2552,3781,2010,729,608,1308,1799,8524
26,1992-93,SAS,1992-93SAS,82,49,33,0.61,19855,3311,6762,3075,6070,236,692,1794,2346,919,2542,3461,2012,582,514,1227,1844,8652
25,1993-94,SAS,1993-94SAS,82,55,27,0.671,19780,3178,6688,2929,5974,249,714,1597,2151,1189,2597,3786,1896,561,450,1198,1662,8202
24,1994-95,SAS,1994-95SAS,82,62,20,0.756,19855,3236,6687,2802,5529,434,1158,1836,2487,1029,2661,3690,1919,656,456,1246,1871,8742
23,1995-96,SAS,1995-96SAS,82,59,23,0.72,19780,3148,6602,2630,5282,518,1320,1663,2261,937,2586,3523,2044,645,536,1195,1820,8477
22,1996-97,SAS,1996-97SAS,82,20,62,0.28,19730,2827,6391,2449,5211,378,1180,1386,1929,1101,2129,3230,1661,646,431,1243,1764,7418
21,1997-98,SAS,1997-98SAS,82,56,26,0.683,19830,2898,6187,2596,5324,302,863,1489,2164,984,2638,3622,1839,516,568,1318,1731,7587
20,1998-99,SAS,1998-99SAS,50,37,13,0.476,12075,1740,3812,1568,3291,172,521,988,1415,614,1584,2198,1101,421,351,759,1010,4640
19,1999-00,SAS,1999-00SAS,82,53,29,0.659,19855,2952,6393,2622,5511,330,882,1652,2214,927,2666,3593,1819,614,551,1233,1716,7886
18,2000-01,SAS,2000-01SAS,82,58,24,0.714,19830,2884,6262,2439,5168,445,1094,1673,2340,902,2712,3614,1778,568,576,1145,1551,7886
17,2001-02,SAS,2001-02SAS,82,58,24,0.714,19855,2913,6363,2475,5152,438,1211,1668,2249,907,2566,3473,1643,625,537,1180,1575,7932
16,2002-03,SAS,2002-03SAS,82,60,22,0.732,19830,2908,6297,2459,5027,449,1270,1591,2194,939,2556,3495,1636,629,529,1295,1672,7856
15,2003-04,SAS,2003-04SAS,82,57,25,0.695,19755,2842,6434,2434,5294,408,1140,1409,2069,1029,2669,3698,1676,661,537,1203,1667,7501
14,2004-05,SAS,2004-05SAS,82,59,23,0.72,19805,2923,6450,2416,5055,507,1395,1535,2120,987,2489,3476,1771,613,543,1126,1717,7888
13,2005-06,SAS,2005-06SAS,82,63,19,0.768,19805,2993,6342,2469,4980,524,1362,1327,1891,851,2548,3399,1717,543,467,1126,1714,7837
12,2006-07,SAS,2006-07SAS,82,58,24,0.72,19780,2999,6328,2404,4767,595,1561,1486,1980,761,2577,3338,1814,587,417,1137,1588,8079
11,2007-08,SAS,2007-08SAS,82,56,26,0.695,19730,2938,6424,2344,4814,594,1610,1350,1774,771,2612,3383,1718,521,337,1035,1537,7820
10,2008-09,SAS,2008-09SAS,82,54,28,0.671,19905,3042,6534,2417,4914,625,1620,1249,1641,728,2638,3366,1736,474,329,963,1546,7958
9,2009-10,SAS,2009-10SAS,82,50,32,0.622,19780,3150,6659,2596,5112,554,1547,1458,1969,887,2621,3508,1829,516,381,1116,1669,8312
8,2010-11,SAS,2010-11SAS,82,61,21,0.744,19780,3148,6628,2463,4901,685,1727,1521,1984,829,2603,3432,1836,602,372,1101,1556,8502
7,2011-12,SAS,2011-12SAS,66,50,16,0.622,15940,2611,5463,2059,4058,552,1405,1067,1427,683,2153,2836,1528,490,293,895,1143,6841
6,2012-13,SAS,2012-13SAS,82,58,24,0.72,19880,3210,6675,2547,4911,663,1764,1365,1725,666,2721,3387,2058,695,446,1206,1427,8448
5,2013-14,SAS,2013-14SAS,82,62,20,0.758,19755,3326,6844,2628,5087,698,1757,1289,1642,762,2786,3548,2064,604,420,1180,1495,8639
4,2014-15,SAS,2014-15SAS,82,55,27,0.683,19955,3208,6854,2531,5007,677,1847,1368,1754,806,2772,3578,2000,657,444,1146,1564,8461
3,2015-16,SAS,2015-16SAS,82,67,15,0.817,19705,3289,6797,2719,5279,570,1518,1342,1672,770,2831,3601,2010,677,485,1071,1433,8490
2,2016-17,SAS,2016-17SAS,82,61,21,0.756,19805,3222,6864,2469,4937,753,1927,1440,1806,821,2777,3598,1954,655,484,1101,1498,8637
1,2017-18,SAS,2017-18SAS,7,4,3,0.183,1680,263,614,214,466,49,148,112,153,93,241,334,146,54,49,103,114,687
39,1979-80,SDC,1979-80SDC,82,35,47,0.451,19755,3524,7494,3347,6951,177,543,1595,2167,1294,2308,3602,1688,664,288,1443,1896,8820
38,1980-81,SDC,1980-81SDC,82,36,46,0.451,19730,3477,7283,3345,6876,132,407,1651,2246,1169,2144,3313,2098,764,292,1407,2078,8737
37,1981-82,SDC,1981-82SDC,82,17,65,0.244,19755,3552,7101,3453,6763,99,338,1693,2341,1131,2196,3327,1878,636,299,1570,2353,8896
36,1982-83,SDC,1982-83SDC,82,25,57,0.329,19830,3625,7634,3561,7372,64,262,1589,2195,1394,2108,3502,2087,820,408,1600,2284,8903
35,1983-84,SDC,1983-84SDC,82,30,52,0.378,19730,3634,7325,3610,7197,24,128,1785,2424,1307,2382,3689,1981,567,385,1515,2020,9077
39,1979-80,SEA,1979-80SEA,82,56,26,0.683,19830,3554,7565,3495,7376,59,189,1730,2253,1380,2550,3930,2043,750,428,1496,1865,8897
38,1980-81,SEA,1980-81SEA,82,34,48,0.439,19780,3343,7145,3311,7028,32,117,1813,2376,1167,2434,3601,1945,628,438,1524,1986,8531
37,1981-82,SEA,1981-82SEA,82,52,30,0.646,19830,3505,7178,3467,7025,38,153,1747,2362,1103,2544,3647,2103,691,460,1351,2057,8795
36,1982-83,SEA,1982-83SEA,82,48,34,0.598,19805,3597,7277,3568,7139,29,138,1796,2459,1152,2569,3721,2278,677,437,1533,1969,9019
35,1983-84,SEA,1983-84SEA,82,42,40,0.524,19780,3460,7083,3433,6943,27,140,1918,2460,1064,2332,3396,2233,636,350,1360,1884,8865
34,1984-85,SEA,1984-85SEA,82,31,51,0.402,19705,3277,6910,3232,6725,45,185,1777,2305,1019,2287,3306,2185,649,343,1493,1974,8376
33,1985-86,SEA,1985-86SEA,82,31,51,0.402,19930,3335,7059,3256,6759,79,300,1815,2331,1145,2256,3401,1977,745,295,1435,2168,8564
32,1986-87,SEA,1986-87SEA,82,39,43,0.5,19855,3593,7451,3402,6880,191,571,1948,2571,1373,2395,3768,2184,705,450,1509,2224,9325
31,1987-88,SEA,1987-88SEA,82,44,38,0.549,19855,3544,7443,3323,6805,221,638,1826,2442,1313,2314,3627,2146,775,447,1376,2380,9135
30,1988-89,SEA,1988-89SEA,82,47,35,0.585,19780,3564,7478,3271,6704,293,774,1775,2379,1397,2238,3635,2083,864,494,1403,2027,9196
29,1989-90,SEA,1989-90SEA,82,41,41,0.512,19905,3466,7243,3235,6593,231,650,1606,2167,1323,2255,3578,1874,701,335,1336,2064,8769
28,1990-91,SEA,1990-91SEA,82,41,41,0.512,19880,3500,7117,3364,6690,136,427,1608,2143,1222,2173,3395,2042,861,380,1404,1973,8744
27,1991-92,SEA,1991-92SEA,82,47,35,0.585,19855,3380,7128,3175,6481,205,647,1772,2263,1282,2257,3539,1877,775,448,1323,1952,8737
26,1992-93,SEA,1992-93SEA,82,55,27,0.671,19780,3473,7140,3255,6530,218,610,1720,2259,1222,2254,3476,1906,944,409,1267,1971,8884
25,1993-94,SEA,1993-94SEA,82,63,19,0.768,19730,3338,6901,3096,6179,242,722,1769,2374,1148,2233,3381,2112,1053,365,1262,1914,8687
24,1994-95,SEA,1994-95SEA,82,57,25,0.695,19830,3310,6741,2819,5436,491,1305,1944,2564,1068,2337,3405,2115,917,392,1295,2067,9055
23,1995-96,SEA,1995-96SEA,82,64,18,0.78,19880,3074,6401,2493,4805,581,1596,1843,2424,954,2449,3403,1999,882,393,1441,1967,8572
22,1996-97,SEA,1996-97SEA,82,57,25,0.707,19780,2995,6415,2436,4832,559,1583,1725,2295,1010,2271,3281,1931,904,388,1231,1803,8274
21,1997-98,SEA,1997-98SEA,82,61,21,0.744,19755,3052,6458,2431,4889,621,1569,1521,2109,931,2225,3156,1986,804,376,1145,1812,8246
20,1998-99,SEA,1998-99SEA,50,25,25,0.329,12100,1756,3976,1447,3077,309,899,922,1354,676,1422,2098,1087,393,201,765,1047,4743
19,1999-00,SEA,1999-00SEA,82,45,37,0.573,19780,3108,6946,2562,5335,546,1611,1363,1960,1042,2483,3525,1878,657,345,1152,1776,8125
18,2000-01,SEA,2000-01SEA,82,44,38,0.549,19805,3029,6649,2563,5480,466,1169,1454,1986,999,2422,3421,1792,657,409,1252,1733,7978
17,2001-02,SEA,2001-02SEA,82,45,37,0.571,19830,3131,6681,2642,5389,489,1292,1263,1672,968,2333,3301,1926,698,364,1124,1732,8014
16,2002-03,SEA,2002-03SEA,82,40,42,0.5,19855,2887,6599,2431,5308,456,1291,1325,1780,963,2385,3348,1775,679,295,1085,1712,7555
15,2003-04,SEA,2003-04SEA,82,37,45,0.488,19805,2939,6590,2216,4654,723,1936,1363,1782,907,2318,3225,1782,661,387,1188,1784,7964
14,2004-05,SEA,2004-05SEA,82,52,30,0.646,19755,2882,6498,2216,4674,666,1824,1683,2131,1041,2311,3352,1487,553,338,1113,1944,8113
13,2005-06,SEA,2005-06SEA,82,35,47,0.451,19830,3077,6711,2472,5080,605,1631,1652,2104,1013,2233,3246,1696,622,306,1208,1933,8411
12,2006-07,SEA,2006-07SEA,82,31,51,0.402,19830,3047,6628,2522,5177,525,1451,1511,1911,928,2322,3250,1695,631,301,1268,1801,8130
11,2007-08,SEA,2007-08SEA,82,20,62,0.268,19830,3125,7032,2812,6093,313,939,1436,1866,971,2688,3659,1748,531,400,1310,1680,7999
23,1995-96,TOR,1995-96TOR,82,21,61,0.293,19830,3084,6598,2670,5430,414,1168,1412,1953,1071,2213,3284,1927,745,493,1544,1987,7994
22,1996-97,TOR,1996-97TOR,82,30,52,0.394,19830,2897,6632,2308,5008,589,1624,1446,2008,1135,2254,3389,1714,722,517,1347,1883,7829
21,1997-98,TOR,1997-98TOR,82,16,66,0.232,19930,2965,6813,2593,5727,372,1086,1479,2060,1187,2149,3336,1746,769,663,1371,1851,7781
20,1998-99,TOR,1998-99TOR,50,23,27,0.305,12075,1660,3940,1434,3278,226,662,1011,1330,712,1447,2159,1036,439,321,799,1139,4557
19,1999-00,TOR,1999-00TOR,82,45,37,0.561,19755,2980,6882,2555,5711,425,1171,1583,2068,1098,2449,3547,1947,666,544,1137,1989,7968
18,2000-01,TOR,2000-01TOR,82,47,35,0.585,19955,3048,6972,2619,5808,429,1164,1482,1984,1118,2529,3647,2004,599,519,1080,1745,8007
17,2001-02,TOR,2001-02TOR,82,42,40,0.524,19755,2919,6727,2532,5618,387,1109,1269,1717,1114,2336,3450,1779,688,454,1174,1771,7494
16,2002-03,TOR,2002-03TOR,82,24,58,0.317,19805,2847,6664,2438,5471,409,1193,1350,1879,1023,2355,3378,1583,609,392,1181,1761,7453
15,2003-04,TOR,2003-04TOR,82,33,49,0.427,19980,2654,6348,2193,5054,461,1294,1237,1650,830,2419,3249,1574,604,402,1164,1748,7006
14,2004-05,TOR,2004-05TOR,82,33,49,0.429,19805,2952,6656,2304,4975,648,1681,1626,2101,844,2444,3288,1670,621,317,1087,1876,8178
13,2005-06,TOR,2005-06TOR,82,27,55,0.354,19955,3013,6639,2405,5019,608,1620,1653,2089,864,2291,3155,1593,529,272,1071,1965,8287
12,2006-07,TOR,2006-07TOR,82,47,35,0.585,19755,3032,6547,2501,5083,531,1464,1562,1982,755,2480,3235,1822,581,321,1104,1672,8157
11,2007-08,TOR,2007-08TOR,82,41,41,0.512,19830,3148,6726,2576,5267,572,1459,1347,1658,790,2496,3286,1953,570,336,959,1596,8215
10,2008-09,TOR,2008-09TOR,82,33,49,0.427,19805,3054,6673,2575,5384,479,1289,1534,1861,802,2513,3315,1835,523,390,1098,1593,8121
9,2009-10,TOR,2009-10TOR,82,40,42,0.5,19780,3199,6631,2681,5234,518,1397,1618,2118,806,2507,3313,1804,469,384,1100,1819,8534
8,2010-11,TOR,2010-11TOR,82,22,60,0.293,19780,3144,6755,2799,5664,345,1091,1491,1976,963,2343,3306,1795,581,350,1206,1807,8124
7,2011-12,TOR,2011-12TOR,66,23,43,0.305,15965,2268,5154,1903,4079,365,1075,1085,1410,697,2074,2771,1382,429,321,1001,1532,5986
6,2012-13,TOR,2012-13TOR,82,34,48,0.439,19980,2979,6685,2408,5020,571,1665,1442,1831,871,2426,3297,1765,595,392,1124,1836,7971
5,2013-14,TOR,2013-14TOR,82,48,34,0.598,19955,2992,6718,2279,4801,713,1917,1608,2055,935,2552,3487,1737,577,343,1159,1882,8305
4,2014-15,TOR,2014-15TOR,82,49,33,0.61,19855,3108,6829,2382,4769,726,2060,1585,2014,881,2526,3407,1701,615,357,1057,1712,8527
3,2015-16,TOR,2015-16TOR,82,56,26,0.695,19780,3006,6669,2298,4754,708,1915,1702,2190,836,2724,3560,1536,636,449,1073,1610,8422
2,2016-17,TOR,2016-17TOR,82,51,31,0.634,19780,3211,6918,2486,4922,725,1996,1615,2028,871,2676,3547,1517,677,400,1041,1708,8762
1,2017-18,TOR,2017-18TOR,6,4,2,0.183,1440,237,526,178,329,59,197,121,145,60,203,263,140,58,37,87,132,654
39,1979-80,UTA,1979-80UTA,82,24,58,0.317,19805,3382,6817,3323,6632,59,185,1571,1943,967,2359,3326,2005,656,362,1543,2006,8394
38,1980-81,UTA,1980-81UTA,82,28,54,0.354,19730,3332,6825,3290,6662,42,163,1595,2080,962,2325,3287,1948,637,386,1423,2110,8301
37,1981-82,UTA,1981-82UTA,82,25,57,0.329,19780,3679,7446,3657,7349,22,97,1714,2282,1147,2362,3509,1895,700,357,1435,2196,9094
36,1982-83,UTA,1982-83UTA,82,30,52,0.38,19755,3525,7342,3481,7159,44,183,1844,2440,1093,2550,3643,2176,758,595,1683,2017,8938
35,1983-84,UTA,1983-84UTA,82,45,37,0.561,19780,3606,7242,3505,6925,101,317,2115,2708,1096,2522,3618,2230,695,604,1510,1978,9428
34,1984-85,UTA,1984-85UTA,82,41,41,0.506,19755,3478,7302,3375,6995,103,307,1878,2434,1081,2554,3635,2143,712,697,1575,1961,8937
33,1985-86,UTA,1985-86UTA,82,42,40,0.524,19780,3453,7083,3418,6914,35,169,1930,2694,1068,2479,3547,2199,717,666,1518,2038,8871
32,1986-87,UTA,1986-87UTA,82,44,38,0.549,19755,3485,7514,3346,7066,139,448,1735,2389,1194,2456,3650,2240,835,628,1403,2040,8844
31,1987-88,UTA,1987-88UTA,82,47,35,0.585,19705,3484,7092,3355,6688,129,404,1802,2404,1066,2553,3619,2407,771,627,1481,1986,8899
30,1988-89,UTA,1988-89UTA,82,51,31,0.634,19730,3182,6595,3068,6215,114,380,2110,2742,1050,2607,3657,2108,720,583,1532,1894,8588
29,1989-90,UTA,1989-90UTA,82,55,27,0.671,19830,3330,6593,3104,5963,226,630,1874,2484,953,2501,3454,2212,677,491,1410,2031,8760
28,1990-91,UTA,1990-91UTA,82,54,28,0.66,19780,3214,6537,3066,6079,148,458,1951,2472,867,2474,3341,2217,652,451,1305,1796,8527
27,1991-92,UTA,1991-92UTA,82,55,27,0.671,19880,3379,6866,3221,6408,158,458,1961,2490,1097,2543,3640,2188,715,448,1264,1746,8877
26,1992-93,UTA,1992-93UTA,82,47,35,0.585,19755,3336,6828,3206,6414,130,414,1907,2491,1041,2463,3504,2177,746,344,1270,1965,8709
25,1993-94,UTA,1993-94UTA,82,53,29,0.659,19830,3207,6729,3028,6170,179,559,1761,2379,1059,2385,3444,2179,751,364,1191,1988,8354
24,1994-95,UTA,1994-95UTA,82,60,22,0.732,19780,3243,6339,2942,5538,301,801,1939,2483,874,2412,3286,2256,758,392,1289,2045,8726
23,1995-96,UTA,1995-96UTA,82,55,27,0.671,19780,3129,6417,2752,5404,377,1013,1769,2302,993,2373,3366,2139,667,418,1215,2046,8404
22,1996-97,UTA,1996-97UTA,82,64,18,0.78,19830,3131,6217,2797,5315,334,902,1858,2416,889,2410,3299,2199,748,418,1259,1981,8454
21,1997-98,UTA,1997-98UTA,82,62,20,0.756,19780,2993,6113,2744,5443,249,670,2044,2644,962,2405,3367,2070,648,412,1260,1961,8279
20,1998-99,UTA,1998-99UTA,50,37,13,0.476,12175,1684,3620,1544,3232,140,388,1158,1510,555,1508,2063,1204,398,276,814,1133,4666
19,1999-00,UTA,1999-00UTA,82,55,27,0.671,19755,2962,6380,2633,5526,329,854,1661,2150,936,2426,3362,2041,629,446,1220,2013,7914
18,2000-01,UTA,2000-01UTA,82,53,29,0.659,19780,2960,6289,2635,5437,325,852,1714,2280,943,2383,3326,2110,661,463,1296,2107,7959
17,2001-02,UTA,2001-02UTA,82,44,38,0.549,19830,2869,6374,2589,5532,280,842,1853,2430,1109,2349,3458,1999,749,523,1353,1971,7871
16,2002-03,UTA,2002-03UTA,82,47,35,0.585,19780,2894,6189,2670,5548,224,641,1750,2349,1021,2381,3402,2103,708,467,1374,1837,7762
15,2003-04,UTA,2003-04UTA,82,42,40,0.524,19780,2690,6172,2438,5386,252,786,1639,2196,1103,2272,3375,1671,583,494,1365,2096,7271
14,2004-05,UTA,2004-05UTA,82,26,56,0.341,19780,2828,6301,2578,5539,250,762,1719,2272,1047,2243,3290,1826,541,374,1292,2189,7625
13,2005-06,UTA,2005-06UTA,82,41,41,0.512,19880,2744,6207,2433,5282,311,925,1774,2466,1071,2380,3451,1772,524,492,1290,2032,7573
12,2006-07,UTA,2006-07UTA,82,51,31,0.634,19805,3069,6471,2715,5415,354,1056,1830,2462,1030,2456,3486,2024,577,339,1277,2067,8322
11,2007-08,UTA,2007-08UTA,82,54,28,0.667,19705,3279,6592,2872,5497,407,1095,1745,2298,942,2410,3352,2165,717,355,1200,1970,8710
10,2008-09,UTA,2008-09UTA,82,48,34,0.598,19880,3143,6623,2751,5501,392,1122,1814,2352,940,2423,3363,2024,719,374,1210,1830,8492
9,2009-10,UTA,2009-10UTA,82,53,29,0.659,19755,3227,6575,2788,5368,439,1207,1654,2233,872,2588,3460,2187,675,400,1246,1859,8547
8,2010-11,UTA,2010-11UTA,82,39,43,0.5,19880,3064,6590,2629,5334,435,1256,1590,2061,898,2338,3236,1921,629,484,1175,1865,8153
7,2011-12,UTA,2011-12UTA,66,36,30,0.463,16165,2523,5531,2250,4686,273,845,1258,1668,861,2055,2916,1439,545,385,936,1441,6577
6,2012-13,UTA,2012-13UTA,82,43,39,0.537,19880,3046,6710,2539,5325,507,1385,1439,1883,989,2457,3446,1859,690,515,1210,1750,8038
5,2013-14,UTA,2013-14UTA,82,25,57,0.341,19780,2951,6652,2408,5075,543,1577,1346,1803,904,2477,3381,1664,570,366,1200,1699,7791
4,2014-15,UTA,2014-15UTA,82,38,44,0.488,19705,2900,6492,2290,4711,610,1781,1391,1929,988,2617,3605,1632,623,489,1256,1583,7801
3,2015-16,UTA,2015-16UTA,82,40,42,0.5,19955,2957,6593,2263,4637,694,1956,1402,1885,880,2665,3545,1555,631,425,1224,1655,8010
2,2016-17,UTA,2016-17UTA,82,51,31,0.634,19755,3033,6515,2242,4387,791,2128,1401,1875,771,2774,3545,1651,550,410,1118,1545,8258
1,2017-18,UTA,2017-18UTA,7,4,3,0.183,1680,257,550,188,356,69,194,87,110,54,229,283,156,70,47,132,139,671
23,1995-96,VAN,1995-96VAN,82,15,67,0.232,19880,2772,6483,2400,5354,372,1129,1446,1998,957,2170,3127,1706,728,333,1347,1852,
22,1996-97,VAN,1996-97VAN,82,14,68,0.22,19780,2819,6453,2374,5179,445,1274,1230,1734,1023,2155,3178,1862,657,464,1301,1755,7313
21,1997-98,VAN,1997-98VAN,82,19,63,0.256,19830,3006,6567,2681,5669,325,898,1586,2145,1081,2313,3394,1960,614,349,1405,1809,7923
20,1998-99,VAN,1998-99VAN,50,8,42,0.207,12175,1643,3838,1495,3385,148,453,1009,1408,650,1359,2009,964,420,199,848,1123,4443
19,1999-00,VAN,1999-00VAN,82,22,60,0.293,19855,2892,6441,2568,5543,324,898,1594,2060,1005,2324,3329,1700,608,346,1381,1881,7702
18,2000-01,VAN,2000-01VAN,82,23,59,0.305,19780,2870,6539,2545,5592,325,947,1457,1892,894,2431,3325,1899,586,359,1291,1733,7522
21,1997-98,WAS,1997-98WAS,82,42,40,0.524,19805,3080,6811,2760,5867,320,944,1489,2156,1121,2341,3462,1900,689,379,1156,1839,7969
20,1998-99,WAS,1998-99WAS,50,18,32,0.256,12050,1768,3969,1589,3389,179,580,845,1198,595,1403,1998,1064,393,193,736,1151,4560
19,1999-00,WAS,1999-00WAS,82,29,53,0.378,19805,3010,6681,2675,5791,335,890,1566,2107,1064,2438,3502,1771,593,383,1320,2149,7921
18,2000-01,WAS,2000-01WAS,82,19,63,0.256,19680,2833,6453,2558,5605,275,848,1704,2245,1016,2370,3386,1647,630,383,1391,1913,7645
17,2001-02,WAS,2001-02WAS,82,37,45,0.476,19730,2938,6664,2633,5878,305,786,1428,1866,1055,2393,3448,1715,570,354,1068,1763,7609
16,2002-03,WAS,2002-03WAS,82,37,45,0.476,19830,2816,6394,2563,5583,253,811,1617,2077,917,2395,3312,1612,621,390,1095,1644,7502
15,2003-04,WAS,2003-04WAS,82,25,57,0.333,19830,2758,6556,2325,5287,433,1269,1579,2211,1115,2392,3507,1537,733,406,1439,1712,7528
14,2004-05,WAS,2004-05WAS,82,45,37,0.573,19780,2966,6794,2452,5296,514,1498,1795,2476,1133,2374,3507,1563,716,347,1172,1807,8241
13,2005-06,WAS,2005-06WAS,82,42,40,0.537,19830,2975,6656,2478,5262,497,1394,1889,2496,1035,2344,3379,1523,658,339,1143,1855,8336
12,2006-07,WAS,2006-07WAS,82,41,41,0.512,19830,3070,6820,2509,5206,561,1614,1855,2425,998,2379,3377,1660,635,375,1133,1823,8556
11,2007-08,WAS,2007-08WAS,82,43,39,0.54,19905,2986,6695,2411,5081,575,1614,1557,1991,1007,2404,3411,1607,632,391,1082,1606,8104
10,2008-09,WAS,2008-09WAS,82,19,63,0.268,19705,2994,6655,2599,5457,395,1198,1494,1948,956,2330,3286,1641,619,365,1146,1679,7877
9,2009-10,WAS,2009-10WAS,82,26,56,0.341,19830,3008,6700,2576,5475,432,1225,1444,1895,966,2458,3424,1557,493,421,1219,1752,7892
8,2010-11,WAS,2010-11WAS,82,23,59,0.305,19930,3048,6888,2656,5706,392,1182,1489,1999,1013,2374,3387,1592,665,502,1258,1850,7977
7,2011-12,WAS,2011-12WAS,66,20,46,0.28,15865,2414,5475,2070,4400,344,1075,1008,1386,775,1975,2750,1262,527,417,1008,1405,6180
6,2012-13,WAS,2012-13WAS,82,29,53,0.378,19855,2910,6693,2365,5198,545,1495,1279,1746,887,2652,3539,1775,598,376,1238,1681,7644
5,2013-14,WAS,2013-14WAS,82,44,38,0.549,20055,3177,6920,2530,5216,647,1704,1253,1715,886,2573,3459,1909,668,377,1204,1675,8254
4,2014-15,WAS,2014-15WAS,82,46,36,0.573,19955,3139,6790,2642,5409,497,1381,1305,1758,862,2801,3663,1969,601,378,1233,1707,8080
3,2015-16,WAS,2015-16WAS,82,41,41,0.512,19755,3238,7033,2529,5050,709,1983,1349,1849,743,2688,3431,2005,708,323,1186,1708,8534
2,2016-17,WAS,2016-17WAS,82,49,33,0.61,19855,3388,7137,2632,5107,756,2030,1421,1812,843,2671,3514,1956,693,336,1162,1745,8953
1,2017-18,WAS,2017-18WAS,6,4,2,0.183,1465,241,533,182,371,59,162,129,166,65,197,262,148,60,34,89,120,670
39,1979-80,WSB,1979-80WSB,82,39,43,0.5,19880,3574,7796,3501,7558,73,238,1552,2048,1334,2723,4057,2201,530,443,1380,1893,8773
38,1980-81,WSB,1980-81WSB,82,39,43,0.5,19780,3549,7517,3484,7276,65,241,1499,2072,1155,2533,3688,2151,641,392,1422,1895,8662
37,1981-82,WSB,1981-82WSB,82,43,39,0.537,19830,3400,7168,3341,6932,59,236,1626,2105,1047,2583,3630,1983,643,397,1390,2072,8485
36,1982-83,WSB,1982-83WSB,82,42,40,0.524,19805,3306,7059,3236,6822,70,237,1452,2059,1099,2430,3529,2046,733,400,1588,1958,8134
35,1983-84,WSB,1983-84WSB,82,35,47,0.439,19905,3344,6907,3273,6625,71,282,1664,2201,1027,2387,3414,2192,556,320,1448,1989,8423
34,1984-85,WSB,1984-85WSB,82,40,42,0.5,19855,3534,7383,3425,6985,109,398,1478,1989,1012,2395,3407,2088,709,393,1282,1869,8655
33,1985-86,WSB,1985-86WSB,82,39,43,0.5,19855,3311,7148,3195,6740,116,408,1704,2286,1066,2432,3498,1748,626,716,1346,1796,8442
32,1986-87,WSB,1986-87WSB,82,42,40,0.524,19705,3356,7397,3313,7179,43,218,1935,2531,1305,2315,3620,1750,755,685,1301,1775,8690
31,1987-88,WSB,1987-88WSB,82,38,44,0.488,19880,3355,7164,3326,7026,29,138,1914,2476,1229,2297,3526,1875,698,502,1384,1922,8653
30,1988-89,WSB,1988-89WSB,82,40,42,0.5,19855,3519,7591,3467,7348,52,243,1789,2318,1254,2354,3608,2048,694,325,1291,2054,8879
29,1989-90,WSB,1989-90WSB,82,31,51,0.402,19830,3598,7581,3561,7384,37,197,1599,2093,1198,2450,3648,2214,561,424,1201,1929,8832
28,1990-91,WSB,1990-91WSB,82,30,52,0.39,19855,3390,7268,3335,6984,55,284,1478,2028,1173,2390,3563,2081,588,468,1359,1927,8313
27,1991-92,WSB,1991-92WSB,82,25,57,0.329,19855,3364,7301,3218,6764,146,537,1521,1956,1069,2345,3414,2011,713,422,1254,1852,8395
26,1992-93,WSB,1992-93WSB,82,22,60,0.293,19805,3302,7065,3128,6487,174,578,1575,2107,1031,2317,3348,2110,673,359,1323,1795,8353
25,1993-94,WSB,1993-94WSB,82,24,58,0.317,19705,3195,6826,2974,6082,221,744,1618,2162,1071,2189,3260,1823,701,321,1403,1715,8229
24,1994-95,WSB,1994-95WSB,82,21,61,0.293,19855,3176,6899,2743,5635,433,1264,1457,2013,1044,2219,3263,1749,648,404,1301,1949,8242
23,1995-96,WSB,1995-96WSB,82,39,43,0.5,19805,3202,6618,2709,5406,493,1212,1511,2076,930,2327,3257,1815,592,506,1327,1981,8408
22,1996-97,WSB,1996-97WSB,82,44,38,0.549,19855,3208,6678,2877,5677,331,1001,1400,1979,1010,2420,3430,1921,712,402,1289,1815,8147